{
"1101":[
[1,0,1,1,1,1,1,1,1,1,1,1,1,1,1,0,1,1,1,1],
[1,1,1,1,0,1,1,1,0,0,0,0,0,1,1,1,1,1,0,1],
[1,1,1,1,1,1,1,0,0,0,0,0,0,0,1,1,1,1,1,1],
[1,1,1,1,1,1,0,1,1,0,0,1,1,0,0,1,1,1,1,1],
[1,1,0,0,1,1,0,1,1,0,0,1,1,0,0,1,1,0,0,1],
[1,1,1,1,0,1,0,0,0,0,0,0,0,0,0,1,1,0,1,1],
[1,1,1,1,0,0,0,0,1,1,1,1,0,0,0,1,0,0,1,1],
[0,1,1,1,1,0,0,1,1,1,1,1,1,0,0,0,0,1,1,1],
[1,1,1,1,1,1,0,1,1,0,0,1,1,0,0,0,0,1,1,1],
[1,1,1,1,1,1,0,0,0,0,0,0,0,0,0,1,1,1,1,0],
[1,1,1,0,1,1,1,0,0,0,0,0,0,0,0,0,1,1,1,1],
[1,1,1,0,1,1,1,1,0,0,0,0,0,0,0,0,0,1,1,1],
[1,0,0,0,0,0,1,1,1,1,0,0,0,0,0,0,0,0,1,1],
[1,1,1,0,1,1,1,1,1,1,1,1,1,1,1,1,1,0,0,1],
[1,1,1,0,1,1,1,1,1,1,1,1,1,1,1,1,1,1,0,1],
[1,1,1,0,1,1,1,1,1,1,1,1,0,1,1,1,1,1,0,1],
[1,1,0,0,0,1,1,1,1,1,1,1,0,1,1,1,1,0,1,1],
[1,0,1,1,1,0,1,1,1,1,0,0,0,0,0,1,1,1,1,1],
[0,1,0,0,0,1,0,1,1,1,1,1,0,1,1,1,1,1,1,1],
[0,1,0,0,0,1,0,1,1,1,1,1,0,1,1,1,1,1,1,1],
],
"1102":[
[0,0,0,0,0,0,0,0,1,1,1,0,0,0,0,0,0,0,1,0,0,0,0,0,0],
[0,0,0,0,0,0,0,1,1,1,1,0,0,0,0,0,0,0,1,0,0,0,0,0,0],
[0,0,1,1,1,1,1,1,1,1,1,0,0,0,0,0,0,1,1,1,0,0,0,0,0],
[0,0,1,1,1,1,0,0,1,1,1,0,0,0,0,1,1,1,1,1,1,1,0,0,0],
[0,0,1,0,0,0,1,0,0,0,1,0,0,0,0,0,0,1,1,1,0,0,0,0,0],
[0,0,1,0,0,1,1,1,0,1,1,1,1,1,1,1,0,0,1,0,0,0,0,0,0],
[1,1,1,1,0,1,1,1,1,1,0,0,0,0,0,1,1,0,1,0,0,0,1,0,0],
[1,1,1,1,1,1,1,1,0,0,0,1,1,1,0,0,1,1,0,0,0,0,1,0,0],
[1,0,0,0,0,0,1,0,0,0,1,1,1,1,1,0,1,1,1,0,0,1,1,1,0],
[1,0,1,1,1,1,1,1,1,0,1,1,1,1,1,0,1,1,1,0,1,1,1,1,1],
[1,1,1,1,1,1,1,1,1,0,1,1,1,1,1,0,1,1,1,0,0,1,1,1,0],
[0,0,0,0,0,0,1,1,1,0,0,1,1,1,0,0,0,0,1,0,0,0,1,0,0],
[0,0,1,0,0,0,1,0,0,0,0,0,0,0,0,0,1,1,1,0,0,0,1,0,0],
[0,1,1,1,0,0,1,0,0,1,1,1,0,0,0,0,1,1,1,0,0,0,0,0,0],
[1,1,1,1,1,0,1,1,0,1,1,1,0,1,1,0,1,1,1,1,1,1,1,1,1],
[0,1,1,1,0,0,1,1,0,1,1,1,0,1,1,1,0,0,1,0,0,0,1,1,1],
[0,0,1,0,0,0,0,1,1,0,0,0,0,1,1,1,1,1,1,1,0,0,1,0,1],
[0,0,1,0,0,0,0,0,1,1,0,0,0,1,1,1,1,0,0,0,1,1,1,0,1],
[0,0,0,0,0,0,0,0,0,0,1,1,1,1,1,0,1,0,0,0,1,1,1,1,1],
[0,0,0,0,0,0,0,0,1,0,0,0,0,0,1,0,0,1,0,0,1,1,1,0,0],
[0,0,0,0,0,0,0,0,1,0,0,0,0,0,1,1,1,1,1,0,0,0,1,0,0],
[0,0,0,0,0,0,0,1,1,1,0,0,0,0,1,1,1,0,1,1,0,0,1,0,0],
[0,0,0,0,0,1,1,1,1,1,1,1,0,0,1,1,1,1,1,1,1,1,1,0,0],
[0,0,0,0,0,0,0,1,1,1,0,0,0,0,1,0,1,1,0,0,0,0,0,0,0],
[0,0,0,0,0,0,0,0,1,0,0,0,0,0,1,1,1,0,0,0,0,0,0,0,0],
],
"1103":[
[0,1,0,0,0,1,0,0,0,0,0,0,0,0,0,0,0,0,0,0,0,0,0,0,0],
[1,1,1,0,1,1,1,0,0,0,0,0,0,0,1,1,1,1,1,1,1,0,0,0,0],
[1,1,1,1,1,1,1,1,0,0,0,0,1,1,1,1,1,1,1,1,1,1,1,0,0],
[1,1,1,1,1,1,1,1,0,0,0,1,1,1,1,0,0,0,0,0,0,1,1,1,0],
[1,1,1,1,1,1,1,1,0,0,0,1,1,1,0,1,1,1,1,1,1,0,1,1,1],
[1,1,1,1,1,1,1,0,0,0,1,1,1,0,1,1,1,1,1,1,1,1,0,1,1],
[0,1,1,1,1,1,0,1,1,1,1,1,0,1,1,1,1,0,0,1,1,1,1,0,1],
[0,0,1,1,1,0,1,1,0,1,1,1,0,1,1,1,0,1,1,0,1,1,1,0,1],
[0,0,0,1,0,0,1,0,0,0,1,0,1,1,1,0,1,1,1,1,0,1,1,0,1],
[0,0,0,0,0,1,1,0,0,0,1,0,1,1,1,0,1,0,1,0,1,1,1,0,1],
[0,0,0,0,1,1,0,0,0,0,1,0,1,1,1,0,1,1,0,1,1,1,1,0,1],
[0,0,0,1,1,0,0,1,0,0,1,0,1,1,1,0,1,1,1,1,1,1,0,1,1],
[0,0,0,1,0,0,0,1,1,0,1,1,0,1,1,1,0,1,1,1,1,0,1,1,1],
[0,0,1,1,0,0,0,0,1,1,1,1,0,1,1,1,1,0,0,0,0,1,1,1,1],
[0,0,1,0,0,0,0,0,0,1,1,1,1,0,1,1,1,1,1,1,1,1,1,1,0],
[0,0,1,1,1,1,1,1,1,1,0,0,1,1,0,0,1,1,1,1,1,1,1,0,0],
[0,0,0,0,0,0,0,1,1,1,0,0,1,1,1,1,1,1,1,1,1,0,0,0,0],
[0,0,0,0,0,0,1,1,1,1,1,1,1,1,0,0,0,0,0,0,1,0,0,0,0],
[0,0,0,0,0,1,1,0,0,1,1,1,0,1,1,0,0,0,0,1,1,0,0,0,0],
[0,0,0,0,1,1,0,0,1,1,0,1,0,0,1,1,0,0,1,1,0,0,0,0,0],
[0,0,0,1,1,0,0,1,1,0,0,1,0,0,0,1,0,1,1,0,0,1,0,1,0],
[0,0,1,1,0,0,1,1,0,0,0,1,0,0,0,0,1,1,0,0,1,1,1,1,1],
[0,1,1,0,0,1,1,0,0,0,0,1,0,0,0,1,1,0,0,0,1,1,1,1,1],
[1,1,0,0,1,1,0,0,0,0,0,1,1,0,1,1,0,0,0,0,0,1,1,1,0],
[1,0,0,1,1,0,0,0,0,0,0,0,1,1,1,0,0,0,0,0,0,0,1,0,0],
],
"1104":[
[0,0,0,0,1,1,1,0,0,0,1,0,0,0,1,0,0,0,1,1,1,0,0,0,0],
[0,0,1,1,1,1,0,0,0,0,1,1,0,1,1,0,0,0,0,1,1,1,1,0,0],
[0,1,1,1,1,1,0,0,0,1,1,1,1,1,1,1,0,0,0,1,1,1,1,1,0],
[0,1,1,1,1,1,1,0,0,1,1,0,1,0,1,1,0,0,1,1,1,1,1,1,0],
[1,1,1,1,1,1,1,1,0,0,1,1,1,1,1,0,0,1,1,1,1,1,1,1,1],
[1,1,1,1,1,1,1,1,1,1,1,1,1,1,1,1,1,1,1,1,1,1,1,1,1],
[1,1,1,0,1,1,1,1,1,1,1,1,1,1,1,1,1,1,1,1,1,0,1,1,1],
[1,1,0,0,1,1,0,0,1,1,1,1,0,1,1,1,1,0,0,1,1,0,0,1,1],
[1,0,0,0,1,0,0,0,0,0,1,1,0,1,1,0,0,0,0,0,1,0,0,0,1],
[1,0,0,0,0,1,1,1,1,1,1,1,1,1,1,1,1,1,1,1,0,0,0,0,1],
[1,0,1,1,1,1,0,0,1,0,0,0,1,0,0,0,1,0,0,1,1,1,1,0,1],
[0,1,1,0,1,0,0,1,0,0,0,0,1,0,0,0,0,1,0,0,1,0,1,1,0],
[1,1,0,0,1,0,0,1,0,0,0,0,0,0,0,0,0,1,0,0,1,0,0,1,1],
[1,0,0,0,0,0,0,0,0,0,0,0,1,0,0,0,0,0,0,0,0,0,0,0,1],
[1,0,0,1,1,1,0,0,0,0,0,0,0,0,0,0,0,0,0,1,1,1,0,0,1],
[0,0,0,1,1,1,1,1,1,1,0,0,0,0,0,1,1,1,1,1,1,1,0,0,0],
[0,0,0,1,1,1,1,1,1,1,0,0,0,0,0,1,1,1,1,1,1,1,0,0,0],
[0,0,0,1,1,1,1,1,1,0,0,0,1,0,0,0,1,1,1,1,1,1,0,0,0],
[0,0,0,0,1,1,1,1,0,0,0,1,1,1,0,0,0,1,1,1,1,0,0,0,0],
[1,0,0,0,0,0,0,0,0,0,1,1,1,1,1,0,0,0,0,0,0,0,0,0,1],
[1,0,1,0,0,0,0,0,0,1,1,1,1,1,1,1,0,0,0,0,0,0,1,0,1],
[1,1,1,0,0,1,0,0,0,0,0,0,0,0,0,0,0,0,0,1,0,0,1,1,1],
[0,1,1,0,1,1,0,0,1,0,0,0,1,0,0,0,1,0,0,1,1,0,1,1,0],
[1,0,1,1,1,1,0,1,1,1,0,1,1,1,0,1,1,1,0,1,1,1,1,0,1],
[1,1,0,1,0,1,1,1,0,1,1,1,0,1,1,1,0,1,1,1,0,1,0,1,1],
],
"1105":[
[0,0,1,1,1,0,0,1,1,0,0,0,0,0,1,1,0,1,1,1,0,1,0,0,0,0,0,0,0,0],
[0,0,0,1,0,0,0,1,1,0,0,0,0,0,1,1,0,0,1,0,0,1,0,1,1,1,0,0,0,0],
[0,0,0,0,0,0,1,1,1,1,0,0,0,1,1,1,1,0,0,0,1,1,1,0,1,0,0,0,0,0],
[0,0,0,0,0,0,1,0,0,1,0,1,1,1,0,0,1,1,1,0,1,0,1,0,0,0,0,0,0,0],
[1,1,1,0,0,1,1,0,0,1,1,0,0,1,1,1,1,0,0,1,1,1,1,1,0,0,0,0,1,0],
[0,1,0,0,0,1,1,1,1,1,1,0,0,1,1,1,1,0,0,1,1,1,1,1,0,0,0,1,1,1],
[0,0,0,0,1,1,0,1,1,0,1,1,0,1,1,1,1,0,1,1,0,1,0,1,1,0,0,0,0,0],
[0,0,0,1,1,1,0,1,1,0,1,1,1,1,1,1,1,1,1,1,1,1,1,1,1,1,1,0,0,0],
[0,0,1,1,1,1,1,1,1,1,1,1,1,1,0,0,1,1,1,1,1,1,1,1,1,1,1,1,1,0],
[1,1,1,1,1,1,1,1,1,1,1,1,1,1,1,1,1,1,1,1,0,1,0,1,1,1,0,0,0,0],
[0,0,0,0,1,1,0,1,1,0,1,1,1,1,1,1,1,1,1,1,1,1,1,1,1,1,0,0,0,0],
[0,0,0,0,1,1,0,1,1,0,1,1,1,1,0,0,1,1,1,1,0,1,0,1,1,1,0,0,0,0],
[0,0,0,0,1,1,0,1,1,0,1,1,1,0,1,1,0,1,1,1,1,0,1,1,1,1,0,0,0,0],
[1,0,0,0,1,1,1,1,1,1,1,1,1,0,0,0,0,1,1,1,1,0,1,1,1,1,0,0,0,1],
[1,1,1,0,1,1,1,1,1,1,1,1,1,0,1,1,0,1,1,1,1,0,1,1,1,1,0,0,1,1],
[0,0,1,1,1,1,1,1,1,1,1,1,1,1,1,1,1,1,1,1,1,1,1,1,1,1,1,1,1,0],
[1,1,0,1,0,0,0,0,0,1,0,0,0,1,0,0,0,0,0,0,0,0,0,0,0,0,0,1,0,1],
[0,1,0,1,1,1,1,1,1,0,1,1,1,0,1,1,1,1,1,1,1,1,1,1,1,1,1,1,0,1],
[1,1,0,1,1,1,1,1,1,0,1,0,1,0,1,1,1,1,1,1,0,0,0,0,0,0,1,1,1,0],
[0,0,1,1,1,1,1,1,1,1,0,1,1,0,1,1,1,1,1,0,0,1,1,1,1,1,0,1,1,1],
[1,1,1,1,1,0,0,0,0,1,1,1,1,0,1,1,1,1,1,0,1,0,0,0,1,1,1,0,1,1],
[1,1,1,1,0,1,1,1,1,0,0,0,0,1,1,1,1,1,1,0,1,0,1,0,1,1,1,0,1,1],
[1,1,1,0,1,1,1,1,1,1,0,1,1,1,0,0,0,0,1,0,1,1,1,0,1,1,1,1,0,1],
[1,1,0,1,1,1,1,0,1,1,0,1,1,0,1,1,1,1,0,1,0,0,0,1,1,1,1,1,0,1],
[1,1,0,1,1,1,0,1,0,1,0,1,1,0,1,0,0,1,0,1,1,1,1,1,1,1,1,1,0,1],
[1,0,1,1,1,1,0,1,1,1,0,1,1,0,1,0,1,1,0,1,1,1,0,0,0,1,1,1,0,1],
[1,0,1,1,1,1,1,0,0,0,1,1,1,0,1,1,0,0,1,1,1,0,1,1,1,0,1,1,0,1],
[1,0,1,1,1,1,1,1,1,1,1,1,1,0,1,1,1,1,1,1,0,1,1,0,1,1,0,1,0,1],
[1,0,1,1,1,1,1,1,1,1,1,1,1,1,0,1,1,1,1,1,0,1,0,1,0,1,0,1,0,1],
[0,1,1,1,1,1,1,1,1,1,1,1,1,1,1,0,1,1,1,1,0,1,0,1,0,1,0,0,1,1],
],
"1106":[
[1,1,1,1,1,1,1,1,1,1,0,0,0,0,0,0,0,0,0,0,0,0,0,0,0,0,0,0,0,0],
[1,1,1,0,0,0,0,0,0,1,0,0,0,0,0,0,0,0,0,0,0,0,0,0,0,0,0,0,0,1],
[1,1,1,1,1,1,1,1,0,1,1,1,1,1,1,1,1,1,0,0,0,0,0,0,0,0,0,0,1,1],
[1,1,1,1,1,1,1,0,0,0,0,0,0,0,0,0,0,1,0,0,0,0,0,0,0,1,1,1,1,1],
[1,1,1,1,1,0,0,0,0,0,0,0,0,0,0,0,1,1,0,0,0,1,1,1,1,1,1,1,1,0],
[1,1,1,1,1,1,1,1,1,1,1,0,0,0,0,0,1,1,1,1,1,1,1,1,1,1,1,1,0,0],
[1,1,1,1,1,1,1,1,1,1,0,0,0,0,0,1,1,1,1,1,1,1,1,1,1,1,1,0,0,0],
[1,1,1,1,1,1,1,1,1,0,0,0,0,0,1,1,1,1,1,1,1,1,1,1,1,0,0,0,0,0],
[1,1,1,1,1,1,1,1,0,0,0,0,0,1,1,1,1,1,1,1,1,1,1,0,0,1,1,1,1,1],
[1,1,1,1,1,1,1,1,0,0,1,1,1,1,1,1,1,1,1,1,1,1,0,0,1,1,0,1,0,1],
[1,1,1,1,1,1,1,0,1,1,1,1,1,0,1,1,1,1,1,1,0,0,0,1,1,1,0,1,0,1],
[1,1,1,1,1,1,1,1,1,1,1,1,0,0,0,1,1,1,1,0,0,0,1,1,0,1,0,1,0,1],
[1,1,1,1,1,1,1,1,1,1,1,1,1,0,0,1,1,1,0,0,0,0,1,1,0,1,0,1,0,1],
[1,1,1,1,1,1,0,0,0,0,0,0,1,1,0,1,0,0,0,0,0,1,1,1,0,1,0,1,0,1],
[1,1,1,1,1,0,0,0,0,1,1,1,0,0,0,1,1,0,0,0,0,1,0,1,0,1,0,0,0,1],
[1,1,1,0,0,0,1,1,1,1,1,1,1,0,0,0,1,1,0,0,0,1,0,1,0,0,0,1,0,0],
[1,1,1,0,0,0,0,1,0,1,1,1,0,0,1,1,0,1,1,1,0,1,0,1,0,1,0,1,0,0],
[0,1,1,0,1,1,0,0,1,1,1,0,0,0,0,1,0,0,0,1,1,1,0,1,0,1,0,1,0,1],
[0,1,1,0,0,1,1,0,0,0,0,0,1,1,0,1,1,0,0,0,0,1,1,1,0,1,0,1,0,1],
[1,0,1,0,1,1,0,0,0,0,1,1,1,0,0,0,1,1,1,0,0,0,0,1,1,1,0,0,0,1],
[1,0,0,0,1,0,0,0,0,1,1,0,1,0,0,0,0,0,0,0,0,0,0,0,1,1,0,1,0,1],
[1,0,0,0,0,0,0,0,1,1,0,0,1,1,1,0,0,0,0,0,0,0,0,1,1,1,0,1,0,1],
[0,0,0,0,0,0,0,1,1,0,0,0,0,0,1,1,1,1,1,1,1,1,1,1,0,1,0,1,0,1],
[0,0,1,0,0,0,0,1,1,1,0,0,0,0,0,0,0,1,0,0,0,1,1,1,1,1,1,1,1,1],
[0,1,1,0,0,0,1,1,0,1,1,1,1,0,0,0,1,1,0,0,0,0,1,0,0,0,0,0,0,0],
[1,1,1,1,0,0,1,0,0,0,0,0,1,1,1,1,1,0,0,0,0,0,1,1,1,1,1,1,1,1],
[1,1,1,1,0,0,1,0,0,0,0,0,0,0,0,0,1,0,0,0,0,0,1,1,0,0,0,0,0,0],
[1,1,1,1,1,0,0,0,0,0,0,0,1,1,1,1,1,0,0,0,0,0,0,1,1,1,0,0,0,1],
[1,1,1,1,1,1,0,0,0,0,0,0,0,0,0,1,1,0,0,0,0,0,0,0,0,1,1,1,1,1],
[1,1,1,1,1,1,1,0,0,0,0,0,0,0,0,0,1,0,0,0,0,0,0,0,0,1,1,0,1,1],
],
"1107":[
[0,0,0,1,0,0,0,1,0,0,0,1,0,0,0,1,1,1,1,0],
[0,0,1,0,0,0,1,0,0,0,1,0,0,0,1,1,0,0,1,0],
[0,0,0,1,0,0,0,1,0,0,0,1,0,1,1,1,1,1,1,0],
[0,0,0,0,1,1,1,0,1,1,1,0,1,1,0,0,1,1,0,0],
[0,0,1,1,1,0,0,1,0,0,0,1,1,0,0,1,1,0,0,0],
[0,1,1,0,0,1,1,1,1,1,1,1,0,0,1,1,0,0,0,0],
[0,1,0,1,1,1,1,1,1,1,1,0,0,1,1,1,1,1,1,0],
[0,1,1,1,0,1,0,1,0,1,0,0,1,1,1,1,0,0,1,1],
[0,1,1,1,1,0,1,0,1,1,1,1,1,1,1,0,1,0,0,1],
[1,1,0,1,1,1,1,1,1,1,1,1,1,0,1,1,1,1,0,1],
[1,0,1,0,0,0,0,0,0,0,0,0,0,1,1,1,0,1,0,1],
[1,0,1,1,1,0,0,0,0,0,0,1,1,1,0,1,0,1,0,1],
[1,0,1,1,1,1,1,1,1,1,1,1,0,0,0,1,0,1,0,1],
[1,0,1,1,1,1,0,0,0,0,0,0,0,0,0,1,1,1,0,1],
[1,0,1,1,1,0,1,0,0,0,0,0,0,0,0,1,1,0,0,1],
[1,0,1,1,1,1,0,0,1,0,1,0,1,0,0,1,0,0,1,1],
[1,0,1,1,1,1,1,1,1,1,1,1,0,0,0,1,0,1,1,0],
[1,1,0,1,1,1,1,1,1,1,1,0,0,0,1,1,1,1,0,0],
[0,1,1,0,0,0,0,0,0,0,0,0,0,1,1,1,0,0,0,0],
[0,0,1,1,1,1,1,1,1,1,1,1,1,1,1,0,0,0,0,0],
],
"1108":[
[0,0,0,0,0,0,0,0,1,1,1,1,0,0,0,0,0,0,0,0],
[0,0,0,0,0,0,0,1,1,0,0,1,1,0,0,0,0,0,0,0],
[0,0,0,0,1,1,1,1,0,0,0,0,1,1,1,1,0,0,0,0],
[0,0,0,1,1,0,0,1,1,1,1,1,1,0,0,1,1,0,0,0],
[0,0,1,1,0,0,0,1,1,0,0,1,1,0,1,0,1,0,0,0],
[0,0,1,0,1,0,1,1,0,0,1,1,1,1,0,0,1,0,0,0],
[0,1,1,0,0,0,1,0,0,0,0,0,0,1,0,0,1,1,0,0],
[0,1,0,1,0,1,1,1,0,1,0,0,1,1,0,1,1,1,1,0],
[1,1,1,1,0,1,1,1,1,0,0,1,1,1,1,0,0,1,1,1],
[1,1,0,0,0,1,1,0,1,0,0,1,0,0,1,1,0,0,0,1],
[1,0,0,0,1,1,0,0,1,0,0,1,0,1,0,1,0,1,0,1],
[0,0,1,0,1,0,1,0,1,0,0,1,0,0,0,1,0,0,1,1],
[1,0,1,1,1,0,0,1,1,1,0,1,1,0,0,1,1,0,1,1],
[0,0,1,1,0,0,1,1,0,1,0,0,1,1,0,0,1,1,1,1],
[1,1,1,0,0,0,1,0,0,0,0,0,0,1,0,0,0,0,0,1],
[1,0,0,0,0,0,1,0,0,0,1,0,1,1,0,1,0,1,0,1],
[1,0,0,1,0,0,1,1,0,0,0,1,1,1,0,0,0,0,0,1],
[1,1,0,0,0,1,0,1,1,1,1,1,1,0,0,0,0,0,1,1],
[0,1,1,1,0,0,0,0,0,0,0,0,0,0,0,0,1,1,1,1],
[0,0,0,1,1,1,1,1,1,1,1,1,1,1,1,1,1,1,0,0],
],
"1109":[
[0,0,0,0,0,0,0,0,0,0,0,0,1,1,1,1,1,1,0,0,0,0,0,0,0],
[0,0,0,0,0,0,0,0,0,0,1,1,1,1,1,0,0,1,1,0,0,0,0,0,0],
[0,1,0,1,0,1,0,1,0,1,1,0,1,0,1,1,1,0,1,1,0,0,0,0,0],
[1,1,1,1,1,1,1,1,1,1,1,0,1,0,0,1,1,1,0,1,1,0,0,0,0],
[1,1,0,1,0,1,0,1,0,1,0,1,1,1,1,1,0,1,1,0,1,0,0,0,0],
[1,0,1,0,1,0,1,0,1,0,1,0,1,0,1,1,0,0,1,1,1,0,0,0,0],
[1,0,0,0,0,0,0,0,0,0,0,0,0,0,1,0,1,1,1,1,1,0,0,0,0],
[1,0,1,0,0,1,0,0,1,0,0,0,1,0,1,1,1,0,0,0,1,0,0,0,0],
[1,0,1,1,1,1,1,1,1,1,1,1,1,0,1,0,1,1,0,0,1,0,0,0,0],
[1,0,1,1,1,1,1,1,1,1,1,1,1,0,1,0,0,1,1,1,1,0,0,0,0],
[1,1,0,1,1,0,0,0,0,0,1,1,0,1,1,0,0,0,1,1,0,0,0,0,0],
[0,1,0,1,0,0,0,0,0,0,0,1,0,1,0,0,0,0,0,0,0,0,0,0,0],
[0,1,0,1,0,1,0,0,0,1,0,1,0,1,0,0,0,0,0,0,0,0,0,0,0],
[0,1,0,1,0,1,1,0,1,1,0,1,0,1,0,0,0,0,1,1,1,1,1,1,1],
[0,1,1,1,0,0,0,0,0,0,0,1,1,1,0,0,0,0,1,0,1,0,1,0,1],
[0,0,1,1,1,0,0,0,0,0,1,1,1,0,0,0,0,0,1,1,1,1,1,1,1],
[0,0,1,0,1,1,0,1,0,1,1,0,1,0,0,0,0,0,1,0,0,0,0,0,1],
[0,0,1,0,1,1,0,1,0,1,1,0,1,0,0,0,0,0,1,1,0,1,0,1,1],
[0,0,1,0,1,1,1,1,1,1,1,0,1,0,0,0,0,0,1,0,0,0,0,0,1],
[0,0,1,1,0,1,1,1,1,1,0,1,1,0,0,0,0,0,1,0,0,0,0,0,1],
[0,0,0,1,0,1,1,1,1,1,0,1,0,0,0,0,0,0,1,0,0,0,0,0,1],
[0,0,0,1,0,0,0,0,0,0,0,1,0,0,0,0,0,0,1,1,0,0,0,1,1],
[0,0,0,1,1,1,1,1,1,1,1,1,0,0,0,0,0,0,0,1,1,1,1,1,0],
[0,0,0,0,1,0,0,0,0,0,1,0,0,0,0,0,0,0,0,1,0,0,0,1,0],
[0,0,1,1,1,1,1,1,1,1,1,1,1,1,0,1,0,1,1,1,1,1,1,1,1],
],
"1110":[
[0,0,0,0,0,0,1,1,1,1,1,1,1,1,1,1,1,1,1,1,1,0,0,0,0],
[0,0,0,0,0,0,1,1,0,0,1,1,1,0,0,1,1,1,0,1,1,0,0,0,0],
[0,0,0,0,1,1,1,0,1,1,0,1,0,1,1,0,1,0,1,0,1,0,0,0,0],
[0,0,0,1,1,0,0,1,1,1,1,0,1,1,1,1,0,1,1,0,1,1,0,0,0],
[1,1,1,1,0,1,1,1,1,1,1,1,1,1,1,1,1,1,1,1,0,1,1,0,0],
[1,0,0,1,0,1,1,1,1,1,0,1,0,1,0,1,1,1,1,1,1,0,1,1,1],
[0,1,1,0,1,1,1,0,0,0,1,1,0,1,1,0,0,0,1,1,1,1,0,1,1],
[1,1,1,1,1,1,0,0,1,0,0,0,1,0,0,0,1,0,0,1,1,1,1,0,0],
[0,1,1,1,0,1,1,1,1,1,1,0,1,0,1,1,1,1,1,1,0,1,1,1,1],
[0,0,0,1,1,1,0,0,0,0,1,1,0,1,1,0,0,0,0,1,1,1,1,1,1],
[0,0,0,0,1,0,1,1,1,1,0,1,0,1,0,1,1,1,1,0,1,1,1,1,1],
[0,0,0,0,1,1,1,1,0,1,1,0,1,0,1,1,0,1,1,1,1,1,0,0,0],
[0,0,0,0,1,0,1,1,0,1,1,0,1,0,1,1,0,1,1,0,1,1,0,0,0],
[0,0,0,0,1,1,0,1,1,1,0,1,1,1,0,1,1,1,0,1,1,1,0,0,0],
[0,0,0,0,1,1,1,0,0,0,1,0,1,0,1,0,0,0,1,1,1,1,0,0,0],
[0,0,0,0,1,0,1,1,1,1,0,1,1,1,0,1,1,1,1,0,1,1,0,0,0],
[0,0,0,0,1,1,1,0,1,0,1,1,1,1,1,0,0,1,0,1,1,0,0,0,0],
[0,0,0,0,0,1,1,0,0,0,1,1,1,1,1,0,0,0,0,1,1,0,0,0,0],
[0,0,0,0,0,1,1,1,1,0,0,0,1,0,0,0,0,1,1,1,1,0,0,0,0],
[0,0,0,0,0,0,1,1,1,0,1,0,1,0,1,0,1,1,1,1,0,0,0,0,0],
[0,0,0,0,0,0,0,1,1,1,1,1,1,1,1,1,1,0,1,0,0,0,0,0,0],
[0,0,0,0,0,0,0,1,0,0,1,0,1,0,1,0,1,0,1,0,0,0,0,0,0],
[0,0,0,0,0,0,0,1,1,0,0,0,0,0,0,0,0,1,1,0,0,0,0,0,0],
[0,0,0,0,0,0,0,0,1,1,1,0,1,1,0,1,1,1,0,0,0,0,0,0,0],
[0,0,0,0,0,0,0,0,0,1,1,1,1,1,1,1,1,0,0,0,0,0,0,0,0],
],
"1111":[
[0,0,0,0,0,0,0,0,0,1,1,1,1,1,0,0,0,0,0,0,0,0,0,0,0],
[0,0,0,0,0,1,1,1,1,1,0,1,0,1,1,1,1,0,0,0,0,0,0,0,0],
[0,0,0,1,1,1,0,0,1,0,0,0,0,1,1,0,1,1,1,0,0,0,0,0,0],
[0,1,1,1,0,1,1,1,1,1,0,0,0,1,0,0,0,1,1,1,0,0,0,0,0],
[0,1,0,0,1,1,0,0,1,1,0,0,0,1,0,0,0,1,0,1,1,0,0,0,0],
[1,1,1,1,1,0,0,0,0,1,1,0,1,1,0,0,1,1,0,0,1,1,1,0,0],
[1,1,0,0,1,1,1,0,0,0,1,1,1,1,1,1,1,0,0,1,1,0,1,1,0],
[1,0,0,0,0,1,1,1,1,1,1,0,0,1,0,1,0,0,1,1,0,0,0,1,0],
[1,1,0,0,0,1,0,0,0,0,1,1,0,0,0,1,1,1,1,0,0,0,1,1,0],
[1,1,1,1,1,1,1,0,0,1,1,1,1,1,1,1,1,1,1,1,1,1,1,1,1],
[1,0,0,0,0,1,1,1,1,1,1,1,1,1,1,0,0,0,1,1,0,0,0,0,1],
[1,0,0,0,1,1,0,0,0,0,1,1,0,1,1,1,1,0,0,1,1,0,0,0,1],
[1,1,1,1,1,1,1,0,0,1,1,1,0,0,1,1,1,1,1,1,1,1,1,1,1],
[1,1,0,0,0,1,1,1,1,1,0,1,0,0,0,1,0,0,0,0,1,1,0,0,1],
[1,0,0,0,1,1,0,1,1,0,0,1,1,0,0,1,1,1,1,0,0,1,1,0,1],
[1,1,0,1,1,0,1,1,0,0,0,0,1,1,1,1,0,0,1,1,1,1,1,1,1],
[0,1,1,1,1,1,1,1,0,0,0,1,1,0,1,1,1,0,0,0,1,1,0,1,0],
[0,0,0,1,0,0,0,1,1,1,1,1,0,0,1,0,1,1,0,1,1,0,0,1,0],
[0,0,0,1,1,0,0,0,1,1,1,1,1,1,1,0,0,1,1,1,1,1,1,1,0],
[0,0,1,1,1,1,0,1,1,1,0,0,0,1,1,0,0,0,1,0,0,1,1,0,0],
[0,1,1,0,1,1,1,1,1,0,0,0,1,1,1,1,0,1,1,1,1,1,0,0,1],
[0,1,0,1,1,0,0,0,1,1,1,1,1,0,0,1,1,1,0,0,0,0,0,1,1],
[0,1,0,1,0,0,0,0,0,0,0,0,0,0,0,0,0,0,0,0,1,1,1,1,1],
[1,1,0,1,0,0,0,0,0,0,0,0,0,0,0,1,1,1,1,1,1,1,1,1,1],
[1,0,1,1,0,0,1,1,1,1,1,1,1,1,1,1,1,1,1,1,1,1,1,1,1],
],
"1112":[
[1,1,1,0,1,1,1,0,1,1,1,1,1,1,1,0,1,1,1,1,1,0,1,1,0,1,1,1,1,1],
[1,1,1,0,0,1,1,1,1,1,1,0,1,1,1,0,1,1,0,1,1,1,1,1,1,1,1,1,1,1],
[1,0,1,1,0,1,1,1,1,1,1,0,1,1,0,0,1,1,0,1,1,1,1,1,0,1,1,1,0,1],
[1,1,1,1,0,1,1,0,1,1,1,0,1,1,0,0,1,1,1,1,1,1,1,1,0,1,1,1,1,1],
[1,1,1,1,0,0,1,0,1,1,1,1,1,0,1,0,0,1,1,1,1,0,1,1,0,1,1,1,1,1],
[1,0,1,1,0,0,1,1,1,1,1,1,1,0,1,0,0,1,1,1,1,0,1,1,1,1,1,1,0,1],
[1,0,1,1,0,0,0,1,1,1,1,1,0,1,1,1,0,1,1,1,1,0,1,1,1,1,1,1,0,1],
[1,1,1,0,1,1,0,1,1,1,1,0,0,1,1,1,0,0,1,1,1,1,1,1,0,1,1,1,0,1],
[1,1,1,0,1,1,0,1,1,1,0,0,1,1,1,1,1,0,1,1,1,1,1,1,0,1,1,1,1,1],
[1,1,1,0,1,1,0,1,1,1,0,0,1,1,0,1,1,0,1,1,1,1,1,1,1,0,1,1,1,1],
[1,1,1,0,1,1,0,1,1,1,0,1,1,1,0,1,1,1,0,1,1,1,1,1,1,0,1,1,1,1],
[1,1,1,1,0,0,1,1,1,1,0,1,1,0,0,0,1,1,0,1,1,1,1,1,0,0,1,1,1,1],
[1,1,1,1,1,1,1,1,1,1,1,0,1,0,0,0,1,0,0,1,1,1,1,1,0,1,1,1,1,1],
[1,1,1,1,0,0,1,1,1,1,1,0,1,1,0,1,1,0,1,1,1,1,1,1,0,0,1,1,1,1],
[1,1,1,0,0,0,0,1,1,1,1,1,0,1,0,1,0,1,1,1,1,1,1,0,0,0,1,1,1,1],
[1,1,1,0,0,0,0,1,1,1,1,1,1,0,1,0,1,1,1,1,1,1,1,0,1,0,0,1,1,1],
[1,1,1,0,0,0,0,1,1,1,1,1,1,1,0,1,1,1,1,1,1,1,0,0,1,1,0,1,1,1],
[1,1,1,1,1,1,1,1,1,1,1,1,1,1,0,1,1,1,1,1,1,1,0,0,1,1,0,1,1,1],
[1,1,1,1,0,0,1,1,1,1,1,0,0,0,0,0,0,1,1,1,1,1,0,0,1,1,0,0,1,1],
[1,1,1,1,0,0,1,1,1,1,0,0,0,0,0,0,0,0,0,1,1,0,0,1,1,1,1,0,0,1],
[1,1,1,1,0,0,1,1,1,1,0,1,0,0,1,0,1,0,0,1,1,0,0,1,1,1,1,0,0,1],
[1,1,1,1,0,0,1,1,1,1,1,1,1,0,1,1,1,0,1,1,1,1,0,1,1,0,1,0,0,1],
[1,1,1,1,0,0,1,1,1,1,1,1,1,0,1,1,1,0,1,1,1,1,0,1,1,0,1,0,1,1],
[1,1,1,1,0,0,1,1,1,1,1,0,1,0,1,0,1,0,1,1,1,1,1,0,1,1,1,0,1,1],
[1,1,1,0,0,0,1,1,1,1,1,0,1,0,1,0,1,1,1,1,1,1,1,1,0,1,0,1,1,1],
[1,1,1,0,0,1,1,1,1,1,1,0,1,0,1,0,1,1,1,1,1,1,1,1,1,0,1,1,1,1],
[1,1,1,0,0,1,1,1,1,1,1,0,1,0,1,0,0,0,1,1,1,1,1,0,1,1,1,0,1,1],
[1,1,1,0,0,1,1,1,1,1,1,0,1,1,1,0,0,0,1,1,1,1,0,0,0,1,0,0,0,1],
[1,1,1,0,0,1,1,1,1,1,1,0,0,1,0,0,0,0,1,1,1,1,1,1,0,0,0,1,1,1],
[1,1,1,0,0,1,1,1,1,1,1,0,0,0,0,0,0,0,1,1,1,1,0,1,1,1,1,1,0,1],
],}