{
"11301":[
[1,1,0,0,1,0,0,1,0,0,0,1,1,0,0,1,1,1,0,1],
[1,1,1,0,1,1,0,1,1,0,0,0,0,1,1,0,0,1,1,1],
[0,1,1,0,0,0,0,1,1,0,0,0,1,1,1,0,1,1,0,1],
[0,0,1,0,1,0,0,1,1,0,1,0,1,1,0,1,1,0,0,1],
[0,0,0,1,1,1,0,1,1,1,1,1,0,0,1,1,0,1,0,1],
[1,0,0,0,1,1,1,1,1,1,1,0,0,0,1,0,0,0,1,1],
[1,1,0,0,0,1,0,1,1,1,0,0,0,0,1,1,1,1,1,0],
[0,0,0,0,0,1,1,1,1,0,0,0,0,1,1,1,0,0,1,1],
[0,0,1,1,0,0,1,1,1,0,0,0,1,1,0,0,0,0,0,1],
[0,1,1,1,0,0,1,1,1,0,0,0,1,0,0,1,1,0,0,1],
[1,1,1,0,0,1,1,1,1,0,0,0,1,0,0,1,0,0,1,1],
[0,0,0,0,0,0,1,1,1,0,0,0,1,1,0,1,1,0,1,0],
[1,0,0,0,0,0,1,1,1,1,1,0,0,1,1,0,1,1,1,1],
[1,1,0,0,1,1,1,0,0,0,1,1,1,1,0,1,0,0,0,1],
[1,0,1,0,1,0,0,0,0,0,0,0,0,0,1,0,0,1,1,0],
[0,0,0,0,1,0,0,0,0,0,0,0,0,0,1,0,1,1,1,1],
[1,1,0,0,1,1,0,0,0,0,0,0,0,0,1,0,1,0,0,1],
[1,1,1,0,0,1,1,0,0,1,1,1,1,1,0,0,1,1,0,1],
[1,0,1,0,0,0,1,1,1,1,0,0,0,1,1,1,0,0,0,1],
[0,1,1,1,1,0,0,1,1,1,0,0,0,0,0,0,1,1,1,1],
],
"11302":[
[0,0,0,0,0,0,0,0,0,0,0,1,1,1,1,1,0,0,0,0,0,0,0,0,0],
[0,0,0,0,0,0,0,0,0,1,1,1,1,1,1,1,1,0,0,1,0,1,0,1,0],
[0,0,0,0,1,1,1,0,0,1,1,1,1,1,1,1,1,1,0,1,0,0,1,0,0],
[0,0,0,1,0,0,0,1,0,1,1,1,1,1,1,1,1,1,0,1,0,1,0,1,0],
[0,1,0,0,1,0,1,1,1,1,1,1,1,1,1,1,1,1,0,0,0,0,0,0,0],
[1,0,1,0,1,1,1,0,1,1,0,0,0,0,0,1,1,1,1,1,0,0,0,0,0],
[0,1,0,1,1,1,1,1,0,1,0,1,0,0,1,0,1,1,1,1,1,0,0,0,0],
[0,0,1,1,0,1,0,1,1,1,0,0,0,0,0,0,1,1,1,1,1,0,0,0,0],
[0,0,1,1,1,0,1,1,1,1,1,0,0,1,1,0,1,1,1,1,1,1,0,0,0],
[0,0,0,1,0,1,0,1,0,1,1,1,1,0,0,1,1,1,1,1,1,1,0,0,0],
[0,0,0,1,1,0,1,1,0,1,1,1,1,0,0,1,1,1,1,1,1,1,0,0,0],
[0,0,0,1,0,1,0,1,0,1,0,0,1,1,1,1,1,1,1,1,1,1,0,0,0],
[0,1,0,1,1,1,1,1,0,1,0,0,1,1,0,1,1,1,1,1,1,1,0,0,0],
[1,0,1,0,0,0,0,0,0,1,0,0,1,1,0,1,0,1,1,1,1,1,0,0,0],
[0,1,0,0,0,1,0,0,0,0,1,0,0,1,0,1,0,1,1,1,1,1,0,0,0],
[0,0,0,0,0,1,0,0,0,0,1,0,0,1,0,1,0,1,1,1,1,1,0,0,0],
[0,0,0,1,1,0,1,1,0,0,1,1,0,1,0,1,1,0,1,1,1,1,0,0,0],
[0,0,0,0,0,1,0,0,0,0,1,1,0,1,0,1,1,0,0,1,1,1,0,0,0],
[0,0,0,0,0,1,0,0,0,0,1,0,0,1,0,1,1,1,1,0,1,1,0,0,0],
[0,0,0,1,1,0,1,0,1,0,1,0,0,1,0,1,1,1,1,0,1,1,0,0,0],
[0,1,1,1,1,1,0,1,0,1,1,0,0,1,0,1,1,1,1,1,0,1,0,1,0],
[1,1,0,1,1,1,1,0,0,0,1,1,0,1,0,1,1,1,1,1,0,1,1,0,1],
[1,0,1,1,1,1,1,1,0,0,1,1,0,1,0,1,1,1,1,1,0,1,1,0,1],
[0,0,1,1,1,1,1,1,1,0,1,1,0,1,0,1,1,1,1,1,0,1,1,1,0],
[0,1,1,1,1,1,1,1,1,1,1,1,0,1,0,0,1,1,1,1,0,1,1,1,1],
],
"11303":[
[1,1,0,0,0,0,0,0,0,0,1,1,0,0,0,0,0,0,0,0,0,1,1,1,1],
[1,1,1,0,0,0,0,0,1,1,0,1,0,0,1,1,0,0,0,1,1,1,1,1,1],
[1,1,1,1,1,1,1,1,1,1,1,1,1,1,1,1,1,1,1,1,1,1,1,1,1],
[1,1,0,0,0,0,1,1,1,1,0,0,0,1,1,0,0,0,1,1,0,0,0,1,1],
[1,1,1,1,1,1,1,1,1,1,1,1,1,1,1,1,1,1,1,1,1,1,1,1,1],
[1,1,1,0,1,1,1,0,0,0,0,1,1,0,1,0,0,0,0,1,1,1,0,1,1],
[1,1,0,0,0,1,0,0,0,0,1,1,1,0,1,1,0,0,0,0,1,0,0,0,1],
[1,0,0,0,0,0,0,0,0,0,1,0,1,0,1,0,1,0,0,0,0,0,0,0,0],
[0,0,0,0,1,1,1,1,0,0,1,0,1,0,0,1,0,0,0,1,1,1,1,0,0],
[0,1,1,1,1,1,1,1,0,0,1,0,1,0,1,0,0,0,1,1,1,1,1,1,0],
[1,1,0,1,1,1,0,1,0,1,1,1,1,1,1,1,0,1,1,1,1,1,1,1,1],
[1,1,1,0,1,0,0,1,0,1,0,0,0,0,0,1,0,1,1,1,1,0,1,1,1],
[1,1,1,1,0,1,1,1,0,1,0,0,0,0,0,1,0,1,1,1,0,1,1,1,1],
[1,1,1,1,1,0,0,0,0,0,1,1,1,1,1,0,0,1,1,0,1,1,0,0,1],
[1,1,1,1,1,0,0,0,0,0,1,1,1,1,1,0,0,0,0,1,1,1,0,1,1],
[0,0,0,0,0,0,0,0,0,0,1,0,0,0,1,0,0,1,0,1,1,1,1,1,1],
[1,1,1,1,1,1,0,0,0,1,0,1,1,1,0,1,0,0,1,0,0,0,0,0,0],
[1,1,0,0,0,0,0,0,1,0,1,0,0,0,1,0,1,0,0,0,0,0,1,1,1],
[1,1,1,1,1,0,1,0,1,0,1,0,0,0,1,0,1,0,1,0,1,1,0,0,1],
[0,0,0,0,0,0,0,0,1,1,0,0,0,0,0,1,1,0,1,0,1,1,0,1,1],
[1,0,1,0,1,0,1,0,0,1,1,1,1,1,1,1,1,0,0,0,0,1,1,1,1],
[1,0,1,0,1,0,1,0,0,1,1,1,1,1,1,1,0,0,1,1,0,0,1,1,1],
[0,1,0,0,1,0,1,0,0,0,1,1,1,1,1,0,0,1,0,0,1,1,0,1,1],
[1,0,1,0,1,0,1,0,1,0,0,1,1,1,0,0,1,1,0,1,1,1,1,1,1],
[1,0,1,0,1,0,1,0,1,0,0,1,0,1,0,0,1,1,1,1,1,1,1,1,1],
],
"11304":[
[1,1,1,1,1,1,1,1,0,0,0,0,0,0,0,0,0,0,0,0,0,0,1,1,1,1,1,1,1,1],
[1,1,1,1,0,1,1,1,0,0,0,0,0,0,0,0,0,0,0,0,0,0,1,1,1,1,1,1,1,1],
[0,1,1,1,0,1,1,1,0,0,0,0,0,0,0,0,0,0,0,0,0,0,0,0,0,0,0,0,0,0],
[0,1,1,1,0,1,1,0,0,1,1,1,0,1,1,1,0,1,1,1,0,0,0,1,0,1,0,1,0,0],
[0,1,1,1,0,1,1,0,1,0,0,1,1,1,0,1,1,1,0,0,1,0,0,0,1,0,0,1,0,0],
[0,1,1,1,0,1,1,0,1,0,0,0,0,0,0,0,0,0,0,0,1,0,0,1,0,1,0,1,0,0],
[0,1,1,1,0,1,1,0,1,1,1,1,1,1,1,1,1,1,1,1,1,0,0,0,0,0,0,0,0,0],
[0,1,1,1,0,1,1,0,0,1,1,1,1,1,1,1,1,1,1,1,0,0,0,1,1,1,1,1,1,0],
[0,1,1,1,0,1,1,0,1,1,1,1,1,1,0,0,0,1,1,1,1,0,0,1,1,1,1,1,1,0],
[0,1,1,1,0,1,1,0,1,1,1,0,0,0,0,0,0,0,1,0,1,0,0,1,1,1,1,1,1,0],
[0,1,1,0,0,0,1,0,1,1,1,0,1,0,0,0,1,0,1,0,1,0,0,1,1,1,1,1,1,0],
[0,1,0,0,0,0,0,1,1,1,0,0,1,0,0,0,1,0,0,1,0,0,0,1,1,1,1,1,1,0],
[0,1,1,1,1,1,1,1,1,1,0,0,0,0,0,0,0,0,0,1,1,0,0,0,1,1,1,1,1,0],
[0,0,0,1,0,1,1,1,1,1,1,0,0,1,1,1,0,0,1,1,0,1,1,0,0,1,1,1,1,0],
[0,0,1,0,0,0,1,0,0,0,0,1,0,0,0,0,0,1,1,0,0,1,0,1,0,0,1,1,1,0],
[0,0,1,0,0,0,1,0,0,0,0,1,1,1,1,1,1,1,0,0,1,1,1,0,1,0,0,1,1,0],
[0,0,0,1,1,1,0,0,0,0,0,0,0,0,0,0,0,0,0,1,0,0,0,1,0,1,0,1,1,0],
[0,1,1,0,1,0,0,1,0,0,0,0,0,0,1,1,1,1,1,1,1,1,1,1,1,1,0,1,1,0],
[0,1,1,0,1,0,1,1,1,0,0,0,0,0,1,0,0,0,0,0,0,0,0,0,0,1,0,1,1,0],
[0,1,1,0,0,0,1,0,1,1,0,0,0,0,1,0,0,0,0,0,0,0,0,0,0,1,0,1,1,0],
[0,1,1,1,1,1,1,0,0,1,0,0,0,1,1,1,0,0,1,1,1,1,0,0,1,1,1,0,1,0],
[0,1,1,1,1,1,1,0,0,1,0,0,1,1,0,1,1,0,0,1,1,0,0,1,1,0,1,1,0,0],
[0,1,1,1,1,1,1,0,1,1,0,1,1,0,0,0,1,1,0,0,0,0,1,1,0,0,0,1,1,0],
[0,1,1,1,1,1,1,0,1,0,1,1,1,1,1,1,1,1,1,0,0,1,1,1,1,1,1,1,1,1],
[0,1,1,1,1,1,1,0,1,0,1,1,1,1,1,1,0,1,1,0,0,1,1,1,1,1,1,0,1,1],
[0,1,1,1,1,1,1,0,1,0,0,1,1,1,1,0,1,1,0,0,0,0,1,1,1,1,0,1,1,0],
[0,1,1,1,1,1,1,0,1,0,0,0,1,1,1,1,1,0,0,0,0,0,0,1,1,1,1,1,0,0],
[1,1,1,1,1,1,0,1,1,1,1,0,0,0,0,0,0,0,0,0,0,0,0,0,1,0,0,0,0,0],
[1,1,1,1,1,1,0,1,0,0,1,0,1,0,0,1,0,0,1,0,0,1,0,0,1,1,0,1,0,0],
[1,1,1,1,1,0,1,0,0,0,0,1,1,1,1,1,1,1,1,1,1,1,1,1,1,1,1,1,1,1],
],
"11305":[
[0,0,1,0,1,0,1,0,1,0,1,0,0,0,0,0,0,0,0,0,0,0,0,0,0,0,0,0,0,0],
[0,0,0,0,1,0,0,0,1,0,0,0,0,0,0,0,0,0,0,0,0,0,0,1,1,0,0,0,0,0],
[0,0,1,0,0,0,1,0,0,0,1,0,0,0,0,0,0,0,0,0,0,1,1,1,1,1,0,0,0,0],
[0,1,1,1,0,1,1,1,0,1,1,1,0,1,1,0,0,0,0,1,1,1,0,0,0,1,1,0,0,0],
[0,1,1,1,1,1,1,1,1,1,1,1,0,0,0,0,0,0,1,1,0,0,1,1,1,0,1,1,0,0],
[0,1,1,1,0,0,0,0,0,1,1,1,0,1,1,0,0,0,1,0,1,1,1,1,1,0,1,1,0,0],
[0,1,1,0,0,0,1,0,0,0,1,1,0,0,0,0,1,1,1,1,1,1,1,1,0,0,0,1,0,0],
[0,1,1,1,0,1,1,1,0,1,1,1,0,1,0,1,1,1,0,0,1,1,1,0,0,1,0,1,0,0],
[0,0,1,1,1,1,1,1,1,1,1,0,0,0,1,1,1,0,0,1,1,1,1,0,1,1,0,1,0,0],
[0,0,0,1,1,1,1,1,1,1,0,0,0,0,1,1,0,0,1,1,1,1,0,0,0,0,1,1,0,0],
[0,0,0,0,0,0,0,0,0,0,0,0,0,1,1,0,1,1,1,1,1,0,0,0,0,1,1,0,0,0],
[0,0,0,0,0,0,0,0,0,0,0,0,1,1,1,1,1,1,1,1,0,0,0,0,0,0,1,1,0,0],
[0,0,0,0,0,0,0,0,0,0,0,1,1,1,1,1,1,1,1,1,1,0,0,1,0,0,0,1,1,1],
[1,1,1,1,0,0,0,1,1,1,1,1,1,1,1,1,1,1,1,0,1,1,1,1,1,0,0,0,0,1],
[0,0,0,1,1,1,1,1,0,0,1,1,1,1,1,1,1,1,0,0,1,1,1,0,1,1,0,1,0,1],
[0,0,0,0,0,0,1,0,1,1,1,1,1,1,0,1,1,0,0,1,1,0,0,1,0,1,0,0,1,1],
[0,0,1,1,1,1,1,0,0,1,1,1,1,0,0,1,1,0,1,1,1,1,1,1,0,1,0,1,1,0],
[1,1,1,0,0,0,1,0,0,0,1,1,0,0,1,1,1,1,0,0,1,1,0,1,0,1,1,1,0,0],
[1,0,1,1,1,1,0,1,0,0,0,1,0,1,1,1,0,0,0,0,0,1,1,0,0,1,1,0,1,0],
[0,0,0,1,1,0,0,1,1,0,0,0,1,1,0,1,1,0,1,1,1,1,1,0,0,0,1,1,1,1],
[0,1,1,0,0,0,1,1,1,1,0,0,0,0,1,0,1,0,0,0,0,1,1,1,0,0,1,0,0,1],
[0,1,1,1,1,1,1,0,0,1,1,0,0,0,0,1,1,0,1,1,1,0,0,1,1,0,0,1,1,1],
[0,1,0,0,0,0,0,0,1,1,1,1,1,1,1,1,0,0,0,1,1,1,1,0,1,1,1,1,0,0],
[0,1,1,0,1,1,0,1,1,0,0,0,0,0,0,0,0,0,0,0,0,0,0,0,0,0,0,0,0,0],
[0,0,1,1,0,0,0,1,0,0,1,1,0,0,0,0,0,1,1,1,1,1,1,1,1,1,1,1,1,0],
[1,0,0,1,1,0,0,1,0,0,1,1,1,1,1,0,0,0,1,0,0,1,0,1,0,1,0,1,0,0],
[1,1,1,0,1,1,0,1,1,0,0,0,1,1,1,1,1,0,0,1,1,0,0,1,0,1,0,1,0,0],
[1,1,1,1,0,1,1,1,1,0,1,0,0,0,0,0,0,0,0,1,1,0,0,1,0,0,1,0,0,0],
[1,1,1,0,0,0,0,0,0,0,1,1,0,1,1,0,0,0,1,0,0,1,0,1,0,0,1,0,0,0],
[1,1,1,1,1,1,0,0,0,1,1,1,1,1,1,1,0,1,1,1,1,1,1,1,1,1,1,1,1,0],
],
"11306":[
[1,1,1,1,1,1,1,1,0,0,1,1,1,1,1,1,1,1,1,0,0,1,1,1,1,1,1,1,1,1],
[1,1,1,1,1,0,0,0,0,0,0,1,0,1,0,1,0,1,0,0,0,0,0,0,0,1,1,1,1,1],
[1,1,1,0,0,0,0,0,0,0,0,0,1,0,0,1,0,1,0,0,0,0,0,0,0,0,0,1,1,1],
[1,1,0,0,0,1,1,1,1,0,0,1,0,1,0,0,1,0,0,0,0,0,1,1,1,0,0,1,1,1],
[1,0,0,1,1,0,0,0,1,1,1,1,1,1,1,1,1,1,1,1,1,1,0,0,0,1,0,0,1,1],
[1,0,1,0,0,0,0,0,0,1,1,0,0,0,1,0,0,0,0,1,1,0,0,0,0,0,1,0,0,1],
[1,0,1,0,0,0,1,0,0,1,1,1,1,1,1,1,1,1,1,1,0,0,0,1,0,0,1,0,0,0],
[0,0,1,0,0,1,0,0,0,0,1,1,1,1,1,1,1,1,1,1,1,0,1,1,0,0,1,0,0,0],
[0,0,1,0,1,1,1,0,0,1,1,1,1,1,1,1,1,1,1,1,1,1,1,1,1,0,1,0,0,1],
[0,0,1,1,0,1,1,1,1,1,1,0,1,1,1,1,1,1,0,1,1,1,0,0,1,0,1,0,1,1],
[1,0,0,0,0,0,1,1,1,1,1,1,0,1,1,1,1,0,1,1,1,0,0,0,0,1,0,1,1,1],
[1,1,1,1,0,0,1,1,1,1,0,1,0,0,1,1,0,1,0,0,1,0,0,0,1,0,1,1,1,0],
[0,0,1,1,1,1,1,1,1,1,0,1,0,0,1,1,0,1,0,0,1,0,1,1,0,1,1,1,0,1],
[1,1,0,1,1,1,1,1,1,1,1,0,0,1,0,0,1,0,0,1,1,1,1,0,1,1,1,0,1,1],
[1,1,1,1,1,0,0,1,1,1,1,1,1,1,1,1,1,1,1,1,1,1,1,1,1,1,0,1,1,1],
[1,1,1,1,0,0,0,1,1,1,1,1,1,0,0,0,0,1,1,1,1,1,0,0,0,1,1,1,1,1],
[1,1,1,0,0,0,0,0,1,1,1,1,0,1,1,1,1,0,1,1,1,0,0,0,0,0,1,1,1,1],
[1,1,1,0,0,0,0,0,0,1,1,0,0,0,0,0,0,0,0,1,0,0,0,0,0,0,0,1,1,1],
[1,1,0,0,0,0,1,0,0,0,1,1,1,1,1,1,1,1,1,0,0,0,1,1,0,0,0,0,1,1],
[1,0,0,0,0,0,0,1,0,0,0,0,0,0,0,0,0,1,1,1,1,0,0,1,1,0,0,0,0,1],
[1,0,0,0,0,0,1,0,0,0,0,0,0,0,0,0,1,1,1,0,1,1,0,0,1,1,0,0,0,1],
[0,0,0,0,0,1,0,1,0,0,0,0,0,0,0,1,1,1,1,1,0,1,0,0,1,1,0,0,0,0],
[0,0,0,0,1,1,0,0,0,1,1,0,0,0,0,1,1,1,1,0,1,1,1,0,0,1,0,0,0,0],
[0,0,0,0,1,1,1,0,0,1,1,0,1,0,0,0,1,1,1,1,1,0,1,1,1,1,0,0,0,0],
[0,0,0,1,1,1,1,0,0,0,0,1,0,0,0,0,0,1,1,1,0,0,1,0,0,0,0,0,0,1],
[0,0,0,1,1,1,1,1,1,1,1,0,0,0,0,0,0,0,0,0,1,1,0,0,0,0,0,0,1,1],
[0,0,0,1,1,1,1,0,0,0,0,0,0,0,0,0,0,0,0,0,0,1,1,1,0,0,0,1,1,1],
[0,0,0,0,1,1,0,1,0,1,0,1,0,1,0,1,0,1,0,1,0,1,0,0,0,0,0,1,1,1],
[0,1,1,1,0,1,1,0,1,1,1,0,1,0,1,0,1,1,1,0,1,0,1,0,0,0,1,1,1,1],
[0,0,0,0,0,1,1,1,1,1,1,1,1,1,0,1,1,1,1,1,1,1,1,1,1,1,1,1,1,1],
],
"11307":[
[1,1,1,0,1,0,1,1,1,0,1,0,1,1,1,1,1,0,1,1],
[1,1,0,1,0,1,0,1,0,0,1,0,1,1,1,1,0,1,0,1],
[1,1,0,0,1,0,0,1,0,1,0,1,0,1,1,1,0,1,0,1],
[1,1,1,0,1,0,1,1,0,1,0,1,0,0,1,0,1,0,1,0],
[1,0,1,1,0,1,1,0,0,1,0,1,0,0,1,0,0,1,0,0],
[0,1,0,1,1,1,1,0,1,0,0,0,1,0,1,1,0,0,0,1],
[0,1,0,1,1,1,1,0,1,0,0,0,1,0,1,1,1,1,1,1],
[1,0,1,0,1,1,1,0,1,0,0,0,1,0,1,1,1,1,0,0],
[0,1,0,0,1,1,1,0,1,0,0,0,1,0,1,1,0,0,1,0],
[0,0,0,1,1,0,1,0,1,0,0,1,1,0,1,0,1,1,0,1],
[1,1,1,1,0,0,0,0,1,0,0,1,1,0,1,1,0,0,1,0],
[1,1,1,0,1,1,0,0,1,0,0,1,1,0,0,1,1,1,0,0],
[0,1,0,1,1,0,1,0,1,0,0,0,1,0,0,0,0,0,1,1],
[0,0,1,1,0,1,1,1,1,1,1,1,1,1,1,1,1,1,0,0],
[0,0,1,0,0,0,0,0,0,0,0,0,0,0,0,0,0,1,1,0],
[0,0,0,1,1,1,1,1,1,1,1,1,1,1,1,1,1,1,0,0],
[0,0,0,0,0,0,0,0,1,0,0,0,1,0,1,1,1,0,0,0],
[0,0,0,1,1,1,0,0,0,1,0,1,0,0,0,1,0,1,1,0],
[0,0,1,1,1,0,1,0,0,1,0,1,0,0,0,0,1,1,1,1],
[1,1,1,1,1,1,1,1,0,1,1,1,0,1,1,1,1,1,0,1],
],
"11308":[
[0,0,0,0,0,0,0,1,1,1,1,0,0,0,0,0,0,0,0,0,0,0,0,0,0],
[0,0,0,0,0,1,1,1,1,1,1,1,1,0,1,0,0,0,0,1,1,0,0,0,0],
[0,0,0,0,1,1,1,1,1,1,1,1,1,1,0,1,0,0,0,1,1,1,1,1,1],
[0,0,0,1,1,1,1,1,1,1,1,1,0,1,0,1,1,0,0,1,0,1,1,0,1],
[0,0,0,1,1,1,1,1,1,1,0,1,0,1,0,1,0,1,0,1,1,0,0,1,1],
[0,0,1,1,1,1,0,1,0,1,0,1,0,1,1,1,1,0,0,1,1,0,0,1,1],
[0,0,1,1,1,0,1,0,1,1,1,1,1,1,1,0,0,0,0,1,0,1,1,0,1],
[0,0,1,1,1,1,1,1,1,1,0,0,0,0,1,1,0,0,0,1,1,1,1,1,1],
[0,1,1,1,1,1,0,0,0,0,0,0,1,1,0,1,0,0,0,1,1,0,0,0,0],
[0,1,1,1,1,0,1,1,0,0,0,1,1,1,1,0,1,0,0,1,1,0,0,0,0],
[1,1,1,1,1,1,1,1,1,0,0,0,1,1,0,0,1,0,0,1,1,1,0,0,0],
[1,1,1,1,1,0,1,1,0,0,1,1,0,0,0,1,1,0,1,1,0,0,1,0,0],
[1,1,1,1,1,0,0,0,0,0,0,1,0,0,1,1,1,1,1,0,0,0,1,0,0],
[1,1,1,1,1,1,0,1,0,0,0,0,1,0,1,1,1,0,1,1,0,0,1,0,0],
[1,1,1,1,1,1,1,0,1,0,1,0,1,0,1,1,0,0,0,1,1,1,0,0,0],
[1,1,1,1,1,1,1,1,1,0,1,0,1,1,0,0,0,0,1,1,1,0,0,0,0],
[0,0,0,0,0,1,1,0,1,1,1,1,0,0,0,0,0,1,0,1,1,1,1,1,0],
[0,0,0,0,1,1,1,1,0,0,0,0,0,0,0,0,1,1,0,1,1,1,0,1,1],
[0,0,0,1,1,1,1,1,1,1,0,0,0,0,1,1,1,1,1,1,1,1,1,1,1],
[0,0,1,1,1,1,1,1,1,1,1,1,0,1,1,0,0,0,0,0,0,0,0,0,1],
[0,1,1,0,0,0,1,1,1,1,1,1,1,1,0,1,0,1,0,1,0,1,0,1,0],
[0,1,1,0,0,0,0,1,1,0,0,0,1,1,0,1,0,1,0,1,0,1,0,1,0],
[0,0,1,1,0,0,0,0,1,0,0,0,1,1,0,0,1,0,0,1,0,1,0,1,0],
[0,0,1,1,1,1,1,1,1,0,0,0,1,1,0,1,0,1,0,1,0,1,0,1,0],
[0,0,1,1,1,1,1,1,0,1,1,1,0,1,0,1,0,1,0,1,0,1,0,1,0],
],
"11309":[
[1,1,1,1,1,0,1,1,1,1,1,1,1,1,1,1,1,1,1,0,1,0,1,1,1],
[1,1,1,1,0,1,1,1,1,1,1,0,1,1,0,1,1,0,0,0,1,0,0,0,1],
[1,0,1,1,1,1,1,0,1,1,0,1,0,1,1,1,1,0,1,1,1,1,1,0,1],
[0,1,0,1,1,1,0,1,0,1,1,0,1,1,1,1,0,0,1,0,1,0,1,0,0],
[1,0,1,1,1,1,1,0,1,1,1,1,1,0,1,0,1,1,1,1,0,1,1,1,1],
[1,1,1,1,1,1,1,1,1,1,1,1,1,1,1,1,0,0,1,0,1,0,1,0,0],
[1,0,1,1,1,0,1,1,0,0,0,0,0,0,0,1,1,0,1,1,1,1,1,0,1],
[1,1,1,1,0,1,1,0,0,1,1,1,1,1,1,0,0,1,0,0,1,0,0,0,1],
[1,1,1,1,1,1,0,1,1,1,1,1,1,1,1,1,0,0,1,0,1,0,1,1,1],
[1,0,1,1,1,0,1,0,1,1,1,1,1,1,1,1,1,0,1,1,0,1,1,0,0],
[0,1,0,1,1,0,1,1,1,1,1,0,1,0,1,1,1,0,1,1,1,1,1,1,1],
[1,0,1,1,1,0,1,1,0,0,0,0,0,0,1,1,1,0,1,1,1,1,0,0,1],
[1,1,1,1,1,0,1,1,0,1,0,0,1,0,0,1,1,0,0,1,1,1,1,1,0],
[1,1,1,1,0,0,1,1,0,0,0,0,0,0,0,1,1,0,0,0,1,0,1,1,1],
[1,1,0,0,1,0,0,1,1,0,0,0,0,0,1,1,1,1,1,1,0,0,0,1,1],
[1,0,1,1,0,0,0,1,1,1,1,1,1,1,1,1,1,1,0,1,0,0,0,0,1],
[0,1,0,0,1,0,1,1,0,1,1,1,1,1,1,1,1,0,1,0,0,0,0,1,1],
[1,0,0,0,1,1,0,0,0,1,0,0,0,1,1,0,1,1,1,1,0,1,1,1,1],
[0,0,0,0,1,0,0,1,1,0,0,0,0,1,0,0,1,1,1,0,1,1,1,1,1],
[1,0,0,0,0,1,1,1,1,0,0,0,0,0,0,1,1,1,1,0,0,1,1,1,0],
[1,1,1,0,1,0,1,1,1,1,1,1,1,1,1,1,1,1,1,0,0,1,1,0,0],
[0,1,1,1,0,0,1,0,1,0,1,0,1,0,1,0,1,0,1,0,0,1,0,1,1],
[0,0,1,1,0,0,1,1,0,1,1,0,1,0,1,0,1,0,1,1,0,0,1,1,1],
[0,0,0,1,0,1,1,1,0,1,1,1,0,1,1,0,1,0,1,1,0,1,1,1,1],
[0,0,0,1,0,1,1,0,1,0,1,1,0,1,1,0,1,0,1,1,0,1,1,1,1],
],
"11310":[
[1,1,1,1,0,0,1,1,0,0,0,0,0,0,0,0,0,0,0,1,1,1,1,1,1,1,1,1,1,0],
[1,1,0,0,0,1,0,1,1,0,0,1,0,0,0,0,0,0,1,1,1,1,1,0,0,0,1,1,0,0],
[1,0,0,0,1,1,1,0,1,1,1,1,0,0,0,0,0,1,1,0,1,1,0,0,0,0,1,1,0,1],
[1,0,0,1,1,1,1,1,0,1,1,1,0,0,0,0,0,1,1,0,1,1,0,0,0,0,1,1,0,1],
[0,0,1,1,1,0,1,1,1,1,1,0,0,0,0,0,0,1,1,0,1,1,0,1,1,0,0,0,0,1],
[0,1,0,0,1,1,0,1,1,1,0,0,0,1,1,1,0,1,0,0,0,0,0,1,1,1,0,0,1,1],
[0,1,1,1,0,1,1,1,0,0,0,1,0,1,1,1,1,1,0,1,1,1,0,1,1,1,1,1,1,1],
[0,0,1,1,1,1,1,0,0,0,1,0,1,1,0,1,1,1,0,1,1,1,1,1,0,0,1,1,1,0],
[0,0,0,1,1,1,0,0,0,1,0,0,1,1,0,0,1,0,0,0,0,0,1,1,0,0,0,0,0,0],
[0,0,0,1,1,1,0,0,1,0,1,0,1,1,0,0,0,0,1,1,1,1,1,1,0,0,0,0,0,0],
[0,0,1,1,1,0,0,0,1,1,0,0,0,1,0,0,0,0,1,1,1,1,1,0,0,0,0,0,1,1],
[0,0,0,0,0,0,0,1,0,0,0,1,1,1,0,0,0,0,0,1,1,1,0,0,0,0,1,1,1,1],
[1,1,0,0,0,0,0,0,1,1,1,1,1,1,1,1,1,1,1,1,1,1,0,0,0,1,1,1,1,1],
[1,1,1,1,1,0,0,0,0,1,1,0,1,0,1,1,1,1,1,1,1,1,0,0,1,1,1,1,0,1],
[0,0,1,1,1,1,1,0,0,0,1,1,0,1,1,1,0,1,0,1,0,1,0,1,0,1,1,1,0,1],
[0,0,1,1,0,1,1,1,0,0,1,1,0,1,1,1,0,1,0,1,0,1,0,0,1,0,1,1,0,1],
[1,1,1,1,0,1,1,1,1,0,1,1,0,1,1,1,1,0,1,1,0,0,1,0,1,1,0,0,0,1],
[1,1,1,1,0,0,0,0,1,0,1,1,1,1,1,1,1,0,1,1,0,0,1,0,1,1,1,0,1,1],
[1,0,0,0,0,0,0,1,0,0,1,1,1,1,1,1,1,1,1,1,0,0,1,0,1,1,0,0,0,0],
[0,1,1,0,0,0,1,1,1,0,1,1,1,0,0,0,1,1,1,1,0,0,1,0,1,0,1,0,1,1],
[1,1,0,0,0,0,0,1,1,0,1,1,0,1,1,1,0,1,1,1,0,0,1,0,1,1,0,0,0,1],
[1,0,0,0,1,1,0,1,0,0,1,1,0,1,1,1,0,1,1,1,0,0,1,0,1,1,1,0,0,1],
[1,1,0,0,1,1,0,1,0,0,1,1,0,1,1,1,1,0,1,1,0,0,1,0,0,1,1,1,1,1],
[1,1,1,1,1,1,1,1,0,0,1,1,1,1,1,1,1,1,1,1,0,0,1,1,0,1,1,1,1,0],
[0,0,1,1,1,1,1,0,1,1,1,1,1,1,1,1,1,1,1,1,0,0,1,1,0,0,0,1,1,0],
[1,1,1,1,1,0,0,1,1,1,0,1,0,1,0,1,0,1,0,1,1,1,1,1,0,0,0,0,1,0],
[1,1,0,0,0,0,1,1,1,1,0,1,0,1,0,1,0,1,0,1,1,1,1,1,1,0,0,0,0,0],
[1,1,0,0,0,0,1,1,1,1,1,0,1,1,0,1,0,1,0,1,1,1,1,1,1,0,0,0,0,0],
[0,0,0,0,0,1,1,1,1,1,0,1,0,1,1,0,1,1,0,1,1,1,1,1,1,1,1,1,0,0],
[0,0,0,0,1,1,1,1,1,1,0,1,0,1,1,0,1,1,0,1,1,1,1,1,1,1,1,1,1,0],
],
"11311":[
[1,0,1,0,1,1,1,1,1,1,1,1,1,1,1,1,1,1,1,1,1,1,1,1,1,1,1,1,1,1],
[1,0,1,0,1,1,1,0,1,0,1,1,1,1,0,0,0,0,0,1,1,1,1,1,1,1,1,1,1,1],
[0,1,0,0,1,1,1,1,0,1,1,1,0,0,1,1,1,1,0,0,0,1,1,1,0,1,0,1,1,1],
[1,0,1,0,1,1,1,1,1,1,1,0,1,1,1,0,0,1,1,1,0,1,1,1,1,0,1,1,1,1],
[1,0,1,0,1,1,1,1,1,1,0,1,1,0,0,0,0,0,0,1,1,0,1,1,1,1,1,1,1,1],
[0,0,0,0,0,0,0,0,0,0,1,0,1,1,1,0,0,0,0,0,1,1,0,1,1,1,1,1,1,1],
[1,0,1,0,1,0,1,0,1,0,1,1,0,0,1,1,0,0,0,0,0,1,1,0,1,1,1,1,1,1],
[1,0,1,0,1,0,1,0,1,0,1,1,1,1,0,1,1,0,0,0,0,0,1,1,0,1,1,1,1,1],
[0,1,0,0,1,0,1,0,1,0,1,1,1,1,1,0,1,0,0,1,0,0,0,1,0,1,1,1,0,1],
[0,1,0,0,1,0,1,0,1,0,1,1,1,1,1,0,1,0,0,1,0,0,0,1,0,1,1,0,1,1],
[0,0,0,0,0,0,0,0,0,0,1,1,1,1,0,1,1,0,0,0,0,0,0,1,0,1,1,1,1,1],
[1,1,1,1,1,1,1,1,1,1,1,1,0,0,1,1,0,0,0,0,1,0,0,1,0,0,1,1,1,1],
[1,1,1,1,1,1,1,1,1,1,1,0,1,1,1,0,0,1,1,1,1,0,1,1,0,1,1,1,1,1],
[1,0,1,0,1,1,1,1,1,1,0,1,1,0,0,0,0,0,0,0,0,1,1,0,1,1,1,1,0,1],
[1,1,0,1,1,0,0,0,0,0,0,0,1,1,1,0,0,0,0,0,1,1,0,1,1,1,1,1,1,0],
[1,1,1,1,0,0,0,1,1,1,0,0,0,1,1,1,0,0,0,1,1,0,1,1,1,0,1,1,1,1],
[1,1,0,0,0,1,1,1,1,1,1,0,0,0,1,1,1,1,1,1,0,0,0,0,0,0,0,1,1,1],
[1,1,0,0,1,1,0,0,0,1,1,0,0,1,0,0,0,0,0,0,1,1,1,1,1,1,0,0,0,1],
[1,0,0,0,1,0,0,0,0,0,1,0,0,1,1,0,0,1,1,1,1,0,0,0,0,1,1,1,0,0],
[1,0,0,1,1,0,0,0,0,0,1,1,0,1,1,0,0,1,1,0,0,0,0,0,0,0,0,1,1,0],
[0,0,1,1,0,0,0,0,0,0,0,1,0,1,1,0,0,1,0,0,0,0,0,0,0,0,0,0,1,1],
[0,1,1,0,0,0,0,0,0,0,0,1,0,0,1,1,0,1,1,0,0,0,0,0,1,0,0,0,0,1],
[1,1,1,0,0,0,1,0,0,0,0,1,1,1,0,1,0,0,1,1,0,0,0,0,1,0,0,0,0,0],
[1,0,1,0,0,0,1,0,0,0,1,1,0,1,0,0,0,0,1,0,1,0,0,0,0,0,1,0,0,0],
[1,0,1,1,1,0,0,0,1,1,1,0,1,1,0,0,1,1,1,1,1,1,0,0,0,0,1,0,0,1],
[0,0,1,1,0,0,0,0,0,0,1,1,1,0,0,0,0,1,0,0,1,1,0,0,0,0,1,0,0,1],
[0,1,1,0,0,0,0,0,0,0,0,1,0,1,0,0,0,1,1,0,0,0,0,0,0,0,1,0,0,1],
[1,1,0,0,0,0,0,0,1,1,1,0,0,0,1,1,0,0,1,1,1,0,0,0,0,0,1,1,0,1],
[1,0,0,0,0,0,1,1,1,1,0,1,1,0,1,1,0,0,1,1,1,1,1,0,0,0,0,1,1,1],
[1,1,1,1,1,1,1,1,0,0,0,0,1,0,1,1,0,1,1,0,0,1,1,1,1,1,1,1,1,1],
],
"11312":[
[1,1,1,1,1,1,1,1,0,0,0,1,0,1,0,1,0,1,0,1,0,0,0,1,1,1,1,1,1,1],
[1,1,0,1,1,1,1,1,1,0,0,1,0,1,0,1,0,1,0,1,0,0,1,1,1,1,1,0,0,1],
[0,1,1,0,0,1,1,1,1,1,0,0,1,0,0,1,0,0,1,0,0,1,1,1,1,1,1,1,0,1],
[0,1,1,1,0,1,0,0,1,1,0,1,0,1,0,1,0,1,0,1,0,1,1,1,1,1,0,0,1,1],
[0,0,1,1,1,1,0,0,0,0,0,1,0,1,0,1,0,1,0,1,0,1,1,0,0,0,0,1,1,1],
[0,0,0,1,1,1,1,0,0,0,0,0,0,0,1,1,1,0,0,0,0,0,0,0,0,0,1,1,1,1],
[1,0,0,1,1,1,1,1,0,0,0,0,1,1,0,0,0,1,1,0,0,0,0,0,0,1,1,1,1,1],
[1,1,0,0,1,1,1,0,0,0,0,1,1,0,0,0,0,0,1,1,0,0,0,0,1,1,1,1,1,1],
[1,0,0,0,1,1,1,1,0,1,1,1,0,0,0,0,0,0,0,1,1,1,0,0,0,0,0,0,1,1],
[0,0,0,1,1,1,0,0,1,1,0,0,1,1,1,1,1,1,1,0,0,1,1,0,1,1,1,0,0,1],
[0,1,1,1,0,0,0,1,1,0,0,1,0,0,0,0,0,0,1,1,0,0,1,1,1,0,0,1,0,1],
[1,1,1,0,0,0,1,1,0,0,1,0,0,0,0,0,0,0,0,1,1,0,0,1,1,0,0,1,0,1],
[0,0,1,1,0,0,0,1,0,0,1,0,0,1,0,0,0,1,0,0,1,0,0,1,1,1,1,0,0,1],
[1,0,0,1,1,0,0,1,0,0,1,0,0,1,0,0,0,1,0,0,1,0,0,1,1,0,1,0,1,1],
[1,1,0,0,1,1,0,1,1,0,1,0,0,0,0,0,0,0,0,0,1,0,1,1,0,1,1,0,1,1],
[1,0,0,1,1,0,0,0,1,0,1,0,1,0,0,0,0,0,1,0,1,1,1,0,0,1,0,1,1,1],
[0,0,1,1,1,0,0,0,1,1,1,0,0,1,1,1,1,1,0,0,1,1,0,0,1,1,0,0,1,1],
[0,1,1,1,0,0,0,0,0,1,1,1,0,0,0,0,0,0,0,1,1,1,1,1,1,1,1,1,1,1],
[1,1,1,0,0,0,0,0,0,0,0,1,1,1,1,1,1,1,1,1,1,1,1,1,1,0,1,0,1,1],
[0,1,1,1,1,0,0,0,1,1,1,1,1,1,0,0,0,0,0,0,1,1,1,0,1,1,1,1,1,1],
[1,0,1,1,1,1,0,1,1,0,0,1,1,1,1,1,1,1,1,1,1,1,0,0,0,0,1,0,1,1],
[1,0,0,1,1,0,1,1,0,0,0,1,0,0,0,0,0,0,0,1,1,0,0,0,0,0,1,0,1,1],
[0,1,1,1,0,1,1,0,0,0,1,1,1,1,1,1,1,1,1,1,0,0,0,1,0,0,0,0,1,1],
[1,1,1,0,1,1,0,0,0,1,1,1,0,0,0,0,0,0,1,1,0,0,0,1,0,0,0,0,0,1],
[0,1,0,1,1,0,0,0,1,1,1,1,1,1,1,1,1,1,1,0,0,0,0,0,0,0,0,0,0,1],
[1,0,1,1,0,0,0,1,1,1,1,0,0,0,0,0,1,1,0,0,0,0,0,0,0,0,0,0,0,0],
[1,0,1,0,0,0,1,1,1,0,1,1,1,1,1,1,1,0,0,0,0,0,0,1,0,0,0,0,0,0],
[1,0,1,0,0,0,1,1,0,0,1,1,1,1,1,1,0,0,0,0,0,0,0,1,0,0,0,0,0,1],
[1,0,1,1,1,1,1,0,0,0,1,0,0,1,1,0,0,0,0,0,0,0,1,1,1,0,0,0,0,1],
[1,0,0,0,1,1,0,0,0,1,1,0,1,1,0,0,0,0,0,0,0,1,1,1,1,1,1,1,1,1],
],}