{"1201":[
[1,1,1,1,1,1,1,1,1,1,1,1,1,1,1,1,1,1,1,1,0,1,1,1,1],
[1,0,1,1,1,1,1,1,1,1,0,0,1,1,1,1,1,1,1,0,1,0,1,1,1],
[0,1,0,1,1,1,1,1,0,0,0,0,0,1,1,1,0,0,1,1,0,1,1,0,1],
[1,0,1,1,1,0,0,1,1,0,0,0,0,1,0,0,0,0,0,1,1,1,0,1,0],
[1,1,1,0,0,0,0,0,0,1,0,1,1,1,0,0,0,1,1,1,1,1,1,0,1],
[1,1,0,0,0,0,0,0,0,0,1,0,1,0,1,1,0,0,0,0,0,0,1,1,1],
[1,0,1,1,1,1,0,0,1,1,0,1,0,1,0,1,1,0,0,0,0,0,0,1,1],
[1,1,1,1,1,0,0,0,0,0,1,0,1,0,1,0,0,1,1,0,0,0,0,0,1],
[1,1,1,1,0,0,0,0,0,0,1,1,0,1,1,1,0,0,0,0,1,1,0,0,1],
[1,1,1,0,0,0,0,0,0,1,0,0,1,0,1,0,1,0,0,0,0,1,1,0,1],
[1,1,0,0,0,0,0,1,1,0,0,1,0,0,0,1,0,1,0,0,0,1,1,1,1],
[1,1,0,0,0,1,1,1,1,0,0,0,0,1,1,0,0,1,1,1,0,0,1,1,1],
[1,0,0,0,1,1,1,1,0,0,0,0,1,1,1,1,0,0,1,1,0,0,1,1,1],
[1,0,0,1,1,1,1,1,0,0,0,1,1,1,1,1,1,0,0,1,1,0,1,1,1],
[1,0,1,1,1,1,1,1,0,0,0,1,1,1,1,1,1,1,0,1,1,1,1,0,1],
[1,1,1,1,0,1,1,1,0,0,1,1,1,1,1,1,1,1,0,0,1,1,0,1,0],
[1,1,1,0,0,0,1,1,0,1,1,1,1,1,1,1,1,0,1,0,1,1,1,0,1],
[1,1,0,0,0,1,0,1,1,1,1,1,1,1,1,0,0,1,0,0,1,1,1,1,1],
[1,1,0,0,1,1,1,0,0,1,1,1,1,1,0,0,1,0,1,0,0,1,1,1,1],
[1,0,0,0,1,1,1,1,1,0,0,1,1,0,0,1,0,1,1,1,0,1,1,1,1],
[1,0,0,1,1,1,1,1,1,0,1,1,0,0,1,0,1,1,1,1,0,1,1,1,1],
[0,0,1,1,0,1,1,1,1,1,1,0,1,1,0,1,1,1,1,1,0,0,1,1,1],
[0,1,1,1,0,0,0,1,1,1,0,1,0,0,1,1,0,0,1,1,1,0,1,1,1],
[0,1,1,1,1,0,0,0,0,0,0,0,1,1,1,0,0,1,0,1,1,0,1,1,1],
[1,1,1,1,1,1,1,0,0,0,1,1,1,1,0,0,1,1,1,0,1,0,1,1,1],
],
"1202":[
[1,1,1,1,1,1,1,1,0,1,1,1,1,1,1,1,0,0,0,0,0,0,0,0,0],
[1,1,0,1,1,1,1,1,0,1,1,1,0,1,0,1,1,1,0,0,0,0,0,0,0],
[1,0,0,0,1,1,1,1,0,1,1,0,1,0,1,1,0,1,1,1,1,1,1,1,1],
[1,1,0,1,1,1,1,1,0,1,0,1,0,0,0,1,1,1,0,0,0,0,0,0,0],
[1,1,1,1,1,1,0,0,0,1,1,0,1,1,0,1,0,0,0,0,0,0,0,0,0],
[1,1,1,1,0,0,1,1,1,0,1,1,0,1,0,1,1,1,1,0,0,0,0,0,0],
[1,1,0,0,1,1,1,0,0,0,0,0,0,0,1,0,0,0,1,1,1,0,0,0,0],
[0,0,0,1,1,1,0,1,1,1,1,1,1,1,1,1,1,1,0,0,0,1,0,0,0],
[0,0,0,1,1,0,1,1,0,0,0,0,0,0,0,0,0,0,1,0,1,1,0,0,0],
[0,0,0,1,1,1,1,0,0,1,1,1,0,1,1,1,1,0,0,1,1,1,0,0,0],
[0,0,0,1,0,0,1,1,1,0,0,0,1,0,0,0,0,1,1,1,1,1,0,0,0],
[0,1,1,1,1,1,0,0,0,1,0,1,0,1,0,1,1,1,1,1,1,1,0,0,0],
[1,1,0,0,0,1,1,0,0,1,0,1,0,1,0,1,0,1,1,1,1,0,0,0,0],
[0,0,0,0,1,1,1,0,0,0,1,0,0,1,0,1,0,1,1,1,1,0,0,0,0],
[0,0,1,1,1,1,0,0,0,0,0,0,0,0,1,0,1,1,1,1,1,0,0,0,0],
[1,1,1,1,0,1,1,1,0,0,0,0,0,0,0,1,1,1,1,1,0,0,0,0,0],
[1,1,0,0,0,1,0,1,1,1,1,0,0,1,1,1,1,1,0,1,0,0,0,0,0],
[0,0,0,0,0,1,0,0,1,0,1,1,1,1,1,0,1,0,0,1,0,0,0,0,0],
[0,0,0,0,1,0,0,0,1,0,0,0,0,0,0,0,1,0,0,0,1,0,0,0,0],
[0,0,0,0,1,0,0,1,0,0,0,0,1,0,0,0,0,1,0,0,1,0,0,0,0],
[0,0,0,0,1,0,1,1,1,1,0,1,0,1,0,1,1,1,1,0,1,0,0,0,0],
[0,0,0,0,1,1,1,1,1,0,1,0,0,0,1,0,1,1,1,1,1,0,0,0,0],
[0,0,0,1,1,1,1,1,1,0,1,0,1,0,1,0,1,1,1,1,1,1,0,0,0],
[0,0,0,0,1,1,1,1,1,1,0,1,1,1,0,1,1,1,1,1,1,0,0,0,0],
[0,0,0,0,0,0,1,1,1,1,1,1,1,1,1,1,1,1,1,0,0,0,0,0,0],
],
"1203":[
[0,0,1,1,1,0,1,1,1,0,0,0,0,0,0,0,1,1,1,1,0,0,0,0,0],
[0,1,1,0,0,1,1,0,0,1,1,1,0,0,0,1,1,0,1,1,1,1,0,0,0],
[1,1,0,0,0,0,0,0,0,0,0,1,0,0,1,1,0,1,1,1,1,1,1,0,0],
[1,0,1,1,1,0,0,0,1,1,0,1,0,0,1,0,1,1,1,1,1,1,1,1,1],
[1,1,1,0,0,0,1,1,0,1,1,1,0,1,1,0,0,1,1,1,1,0,0,0,1],
[0,0,1,1,0,0,0,1,1,1,0,0,0,1,0,0,1,1,1,1,0,1,1,1,0],
[0,0,0,1,1,1,1,1,0,0,0,0,1,1,0,1,0,1,1,0,1,1,1,1,1],
[0,0,1,1,0,1,0,0,0,0,0,0,1,0,0,1,1,1,1,0,0,1,1,1,0],
[0,1,1,0,0,1,1,0,0,0,0,1,1,1,1,0,1,1,1,0,1,1,1,1,0],
[1,1,0,1,0,1,1,1,0,0,1,1,1,1,0,1,1,1,0,1,1,0,1,1,0],
[1,0,0,0,1,0,1,1,1,0,1,0,1,0,1,1,1,0,1,1,0,1,1,0,1],
[0,1,0,1,1,1,1,1,1,1,0,1,1,1,1,1,0,1,1,1,1,0,0,0,1],
[0,1,1,1,1,1,1,0,1,1,1,1,0,1,1,0,1,1,1,0,1,1,1,0,1],
[1,1,1,1,1,0,0,1,1,1,1,1,1,1,0,1,1,1,0,0,1,0,1,1,1],
[1,1,1,0,0,0,1,1,1,1,1,1,0,0,1,1,1,0,0,0,1,1,0,0,1],
[0,0,0,1,1,1,0,0,1,1,1,0,0,1,1,1,0,0,0,0,1,1,1,1,1],
[0,1,1,1,0,1,1,0,0,0,0,0,1,1,1,0,0,0,0,0,1,1,1,1,1],
[0,1,1,0,0,0,1,0,0,0,0,1,0,1,1,0,0,0,0,0,0,1,0,1,0],
[1,1,0,0,0,0,1,1,0,0,1,0,1,1,0,0,1,1,1,1,0,1,0,1,1],
[1,0,0,0,0,1,1,1,1,1,0,1,1,0,0,1,1,0,1,0,1,1,1,1,0],
[1,1,0,0,1,1,0,1,1,0,1,1,0,1,1,1,0,0,0,0,0,0,0,0,1],
[0,1,1,1,1,1,1,0,0,1,1,0,0,0,0,0,0,1,1,1,0,1,1,1,1],
[0,0,1,1,1,1,1,1,1,1,0,1,1,1,0,0,1,1,0,1,1,0,0,0,0],
[0,0,0,0,1,1,1,1,1,0,0,0,0,0,0,1,1,0,1,1,1,1,1,0,1],
[1,1,1,0,0,0,1,1,0,0,1,1,0,1,1,1,0,1,1,0,1,1,1,1,1],
],
"1204":[
[0,1,0,1,0,0,0,0,0,0,1,1,1,1,1,1,0,0,1,0,0,0,0,0,0],
[0,1,0,1,1,1,0,0,1,1,1,1,1,1,1,0,0,0,1,0,0,0,0,0,0],
[0,1,0,0,0,1,1,1,0,1,1,1,1,1,1,1,1,1,1,0,0,0,0,1,1],
[0,0,1,0,1,1,0,0,0,1,1,1,1,1,1,1,1,1,0,0,0,1,1,1,1],
[1,1,1,1,0,0,0,0,0,0,0,1,1,1,1,1,1,0,1,1,1,1,1,1,1],
[1,0,0,1,0,0,0,0,0,0,0,0,1,1,1,1,1,1,1,0,0,1,1,1,1],
[0,0,1,1,0,0,0,0,0,0,0,0,0,0,0,0,0,1,1,1,0,0,0,1,1],
[1,1,1,1,1,0,0,1,1,1,0,0,0,0,1,0,0,0,1,0,1,0,0,0,0],
[0,1,0,0,1,0,1,1,1,1,1,0,0,0,1,0,0,0,1,0,1,0,0,0,0],
[1,1,1,0,1,0,1,1,0,1,1,0,0,0,0,0,0,0,1,0,1,0,0,0,1],
[1,0,1,1,1,1,1,1,0,1,1,0,0,1,1,1,1,0,1,0,1,0,0,1,1],
[0,0,0,1,0,1,1,1,1,1,1,1,1,1,0,0,0,1,1,0,1,0,1,1,1],
[1,0,1,1,0,1,1,1,1,1,1,0,0,0,0,0,0,0,1,0,1,0,1,1,1],
[1,1,1,1,0,0,1,1,1,0,0,0,0,0,1,1,0,0,1,0,1,0,1,1,1],
[0,0,0,0,0,0,1,1,0,0,1,1,0,0,1,1,0,1,1,0,1,0,1,1,1],
[0,0,0,0,0,0,0,1,0,0,1,1,0,0,0,0,1,1,0,1,1,0,1,1,1],
[0,0,0,0,0,0,0,1,1,0,0,0,0,1,1,1,1,0,1,1,0,0,0,1,1],
[0,0,0,0,0,0,0,0,1,1,1,1,1,1,0,0,0,1,1,0,0,0,0,0,0],
[0,0,0,0,0,0,0,0,0,0,0,1,1,0,1,1,1,1,1,1,0,0,0,0,1],
[0,0,0,0,0,0,0,0,0,0,0,0,1,1,1,1,0,1,1,1,1,0,0,1,1],
[0,0,0,0,0,0,0,0,0,0,0,0,0,1,1,0,0,0,1,1,1,0,0,1,1],
[0,0,0,0,0,0,0,0,0,0,0,0,0,1,1,0,0,0,1,1,1,1,0,0,1],
[0,0,0,0,0,0,0,0,0,0,0,0,0,1,0,0,0,0,0,1,1,1,0,0,0],
[0,0,0,0,0,0,0,0,0,0,0,0,0,1,1,1,0,1,1,1,0,1,1,0,1],
[0,0,0,0,0,0,0,0,0,0,0,0,0,1,1,1,1,1,1,0,0,1,1,0,1],
],
"1205":[
[0,0,0,0,1,1,1,1,1,1,1,1,1,0,0,0,0,0,1,1,1,1,1,0,0],
[0,0,0,0,1,1,1,0,0,0,0,1,1,1,1,1,0,1,1,0,0,0,1,1,0],
[0,0,0,0,0,1,1,0,1,0,1,1,1,1,1,1,1,1,0,1,1,1,0,1,1],
[0,0,0,0,0,0,1,0,1,1,1,1,0,0,0,1,1,0,1,1,0,1,1,0,1],
[0,0,0,0,0,0,0,0,0,0,0,0,0,0,1,1,0,0,1,0,0,0,1,0,1],
[1,1,1,1,1,1,1,1,1,1,0,0,0,1,1,0,1,0,1,1,0,1,1,0,1],
[1,1,1,0,0,0,1,1,1,1,1,1,1,1,0,1,1,1,0,1,1,1,0,1,1],
[0,1,1,1,1,1,1,1,1,1,1,1,1,0,1,1,1,0,1,0,0,0,1,1,1],
[0,0,1,1,1,1,1,1,1,1,1,1,0,1,1,1,0,1,1,1,0,1,1,1,1],
[0,0,0,0,0,0,0,0,0,1,1,0,1,0,1,0,1,1,1,0,1,1,1,0,1],
[0,0,0,0,0,0,0,0,1,1,0,1,1,1,0,1,1,1,0,1,1,1,0,1,1],
[0,0,0,0,0,0,0,1,1,0,1,1,1,0,1,1,1,0,1,1,1,1,1,1,0],
[0,0,0,0,0,0,1,1,0,1,1,1,0,1,1,1,0,1,1,1,0,1,0,1,0],
[0,0,0,0,0,1,1,0,1,1,1,0,1,1,1,0,1,1,1,0,1,1,1,0,0],
[0,0,0,0,1,1,0,1,1,1,1,1,0,1,0,1,1,1,0,1,1,0,0,1,0],
[0,0,0,1,1,0,1,1,1,1,1,0,0,0,1,1,1,0,1,1,0,1,1,1,0],
[0,0,1,1,0,0,0,1,1,1,0,0,0,1,1,1,0,1,1,0,0,1,0,0,0],
[0,1,1,0,0,0,0,0,1,0,0,0,1,1,1,0,1,1,0,0,0,1,1,0,0],
[0,1,0,0,1,1,0,0,0,0,0,1,1,1,0,1,1,0,0,0,0,0,0,1,0],
[0,1,0,1,1,1,1,0,0,0,1,1,1,0,1,1,0,0,0,0,0,1,1,1,0],
[0,1,0,1,1,1,1,0,0,1,1,1,0,1,1,0,0,0,0,0,0,1,0,0,0],
[0,1,1,0,1,1,0,0,1,1,1,0,1,1,0,0,0,0,0,0,0,1,1,0,0],
[0,1,1,1,0,0,0,1,1,1,0,1,1,0,0,0,0,0,0,0,0,0,0,1,0],
[0,0,1,1,1,1,1,1,1,0,1,1,0,0,0,0,0,0,0,0,0,0,1,1,0],
[0,0,0,1,1,1,1,1,1,1,1,0,0,0,0,0,0,0,0,0,0,0,1,0,0],
],
"1206":[
[0,0,0,0,0,0,0,0,1,1,0,0,0,0,0,0,0,0,0,0,0,0,0,0,0],
[1,1,0,0,0,0,0,1,0,1,1,0,0,0,0,0,1,1,1,0,1,1,1,0,0],
[0,1,1,0,0,0,1,1,0,0,1,0,0,0,0,1,1,0,0,1,1,0,0,1,1],
[0,0,1,1,0,0,1,0,0,0,1,1,0,0,1,1,0,0,0,0,0,0,0,0,0],
[1,1,0,1,0,1,1,0,0,1,1,1,1,0,1,0,1,1,1,0,0,0,1,1,0],
[0,1,1,1,0,1,0,0,1,1,1,0,1,0,1,1,1,0,0,0,1,1,0,1,1],
[1,0,1,0,1,0,0,0,1,1,0,1,1,1,0,0,1,1,0,0,0,1,1,1,0],
[1,1,1,0,1,0,1,0,1,1,1,1,1,1,1,0,0,1,1,1,1,1,1,0,0],
[0,0,0,1,0,1,0,0,0,1,1,1,1,0,1,1,0,0,0,0,0,0,0,0,0],
[0,0,1,1,0,1,0,0,0,1,0,1,1,1,0,1,1,0,0,0,0,0,0,0,0],
[0,1,1,0,1,1,0,0,1,1,1,1,1,1,1,1,1,1,1,0,0,0,0,0,0],
[1,1,0,1,1,0,0,1,1,0,1,1,0,1,1,1,1,1,1,1,0,1,1,0,0],
[0,0,1,0,0,1,1,1,1,1,0,1,0,1,1,1,1,0,1,1,1,1,0,1,1],
[0,1,1,1,1,0,0,1,1,1,1,1,1,1,1,0,0,1,1,0,1,1,1,0,1],
[1,1,1,0,1,1,1,0,0,0,0,0,1,1,1,1,1,1,1,1,0,0,1,1,1],
[1,1,0,1,0,1,1,1,1,0,0,0,0,0,0,0,1,0,0,1,1,1,1,0,0],
[0,0,1,1,1,1,1,0,0,1,1,0,0,1,1,1,0,1,1,1,1,0,0,1,1],
[1,1,1,1,1,1,1,1,1,1,1,1,1,1,1,1,1,1,1,0,0,1,1,1,1],
[1,1,1,1,1,0,0,1,0,1,0,1,1,1,1,1,1,1,1,1,1,0,1,1,1],
[1,1,1,0,0,1,0,0,1,1,1,0,0,0,1,0,0,1,1,1,1,1,1,0,0],
[1,0,0,0,0,1,0,0,0,1,1,1,1,1,0,0,0,0,1,1,1,1,1,1,1],
[0,0,0,0,0,0,1,0,0,1,1,1,1,0,1,1,1,0,0,0,1,1,1,1,1],
[1,0,0,0,0,0,1,1,0,0,1,1,0,0,0,1,1,1,0,1,1,1,1,1,1],
[1,1,1,1,0,0,0,1,0,1,1,0,0,0,0,0,0,1,1,1,1,1,1,1,1],
[1,1,1,1,1,1,1,0,1,1,0,0,0,0,0,1,1,1,1,1,1,1,1,1,1],
],
"1207":[
[0,0,0,0,0,1,1,1,1,0,0,0,0,0,0,0,0,0,0,0],
[0,0,0,1,1,1,1,0,1,0,0,0,0,0,1,1,1,0,0,0],
[0,0,1,1,1,0,0,0,1,1,0,0,0,1,1,0,1,0,0,0],
[0,1,1,1,0,1,0,0,0,1,1,0,1,1,0,0,1,1,1,0],
[0,1,1,0,0,0,1,0,0,1,1,1,0,0,0,1,0,0,1,0],
[0,0,1,1,0,0,1,1,1,1,1,1,1,0,1,1,0,1,1,0],
[1,1,1,1,1,1,1,1,0,1,1,1,0,1,1,0,0,1,0,0],
[0,1,0,0,1,1,1,1,1,1,1,1,1,1,0,0,1,1,0,0],
[1,0,1,1,0,1,1,1,1,1,1,1,1,1,1,1,1,1,1,0],
[1,1,0,1,1,1,1,1,1,1,1,1,1,0,0,0,0,1,1,1],
[0,1,0,1,1,1,1,1,1,1,0,1,0,1,0,0,0,0,0,1],
[0,1,1,1,0,0,0,1,1,1,1,1,0,1,0,0,0,1,1,0],
[1,1,0,0,0,0,0,0,1,1,1,1,0,1,1,0,1,1,0,0],
[1,0,1,1,0,0,0,0,1,1,1,1,0,0,0,1,1,0,0,0],
[1,0,0,1,1,0,0,1,0,1,1,1,1,0,1,1,1,0,0,1],
[1,1,0,1,1,1,0,1,0,1,0,1,1,0,1,1,0,0,1,1],
[0,1,0,1,1,1,1,0,1,1,0,0,1,1,0,0,0,1,1,0],
[0,1,1,0,1,1,1,0,1,0,0,0,0,1,1,1,1,1,0,0],
[0,0,1,1,0,0,0,1,1,0,0,0,0,0,0,0,0,0,0,0],
[0,0,0,1,1,1,1,1,0,0,0,0,0,0,0,0,0,0,0,0],
],
"1208":[
[0,0,0,0,0,0,0,1,1,1,1,0,0,0,0,0,0,0,0,0,0,0,0,0,0],
[0,0,0,1,0,0,1,1,1,0,1,1,0,0,1,1,0,1,1,0,0,0,0,0,0],
[0,0,1,1,1,0,1,0,1,1,0,1,0,0,0,1,1,1,0,0,0,0,0,1,0],
[1,0,1,1,1,0,1,1,1,1,1,1,0,1,1,1,1,1,1,1,1,0,1,0,1],
[0,0,1,1,1,0,1,1,0,1,0,1,0,1,0,0,1,0,0,1,1,0,0,1,0],
[0,0,1,1,1,0,0,0,0,1,1,1,0,1,1,1,1,1,1,1,1,0,0,0,0],
[0,0,0,1,0,0,0,0,0,1,0,1,0,1,0,0,1,0,0,1,1,0,0,0,0],
[1,1,1,1,1,0,0,0,1,1,1,1,1,1,1,1,1,1,1,1,1,1,0,0,0],
[0,1,0,0,1,1,0,0,1,0,1,0,1,0,1,0,1,0,0,0,0,1,0,0,0],
[1,1,1,0,0,1,1,1,1,0,1,0,1,0,1,0,1,0,1,1,0,1,0,1,1],
[1,0,1,0,0,0,1,0,1,0,1,0,1,0,1,0,1,0,1,1,1,0,1,1,1],
[1,0,1,0,0,1,1,1,1,0,1,0,1,0,1,0,1,0,0,1,1,1,1,1,0],
[1,1,1,0,0,1,0,1,1,0,1,0,1,0,1,0,1,0,0,0,1,0,1,0,0],
[0,1,0,0,0,1,0,1,1,1,1,1,1,1,1,1,1,1,1,1,0,1,0,1,0],
[0,0,0,0,0,1,1,1,0,1,0,0,0,0,0,0,0,1,0,1,1,1,1,1,0],
[0,1,0,0,0,0,1,0,0,1,0,1,0,0,1,0,0,0,1,0,1,0,0,0,0],
[1,0,1,0,0,0,0,0,1,1,0,1,0,0,1,0,0,1,0,1,1,0,0,0,0],
[0,1,0,1,1,1,1,1,1,0,0,0,0,0,0,0,0,0,1,0,1,1,1,0,0],
[0,0,1,1,0,0,0,0,0,0,1,1,1,1,0,0,0,0,0,1,1,0,1,1,1],
[0,1,1,0,0,0,0,1,0,1,1,1,1,1,1,0,1,0,1,0,1,0,0,1,0],
[0,1,0,0,0,0,0,1,1,1,1,0,0,1,1,1,1,0,0,1,1,0,1,1,1],
[0,1,0,0,0,0,0,0,0,0,0,0,0,0,0,0,0,0,1,0,1,0,1,1,1],
[0,1,1,0,0,0,0,0,0,0,0,0,0,0,0,1,0,1,0,1,1,0,1,1,1],
[0,0,1,1,0,0,0,0,0,0,1,0,1,0,1,0,1,0,1,1,0,0,1,1,1],
[0,0,0,1,1,1,1,1,1,1,1,1,1,1,1,1,1,1,1,0,0,0,0,1,0],
],
"1209":[
[1,1,1,1,1,1,1,1,1,1,1,1,1,1,1,1,1,1,1,0,1,1,1,1,1],
[1,0,1,1,1,1,1,0,0,0,0,1,1,1,1,0,1,1,0,1,0,1,1,0,1],
[0,1,0,1,1,1,0,0,0,0,0,0,1,1,0,1,0,1,1,0,1,1,0,1,0],
[1,0,1,1,1,0,0,0,0,0,0,0,0,1,1,0,1,1,1,1,1,1,1,0,1],
[1,1,1,1,1,0,1,1,0,0,0,0,0,0,1,1,1,1,1,1,1,1,1,1,1],
[0,0,1,0,1,1,0,1,1,0,0,0,0,0,0,1,0,0,0,0,0,0,0,0,0],
[0,0,1,1,1,0,0,1,1,0,0,0,0,0,0,1,1,0,0,0,0,0,0,0,0],
[0,0,0,0,0,0,1,1,1,1,1,1,1,1,1,1,1,1,0,0,0,0,0,0,0],
[0,0,0,0,0,0,1,0,0,0,0,0,0,0,0,0,0,1,0,0,0,0,0,0,0],
[0,0,0,0,0,0,1,1,1,1,1,1,1,1,1,1,1,1,0,0,0,0,0,0,0],
[0,0,0,1,1,1,1,1,0,0,0,0,0,0,0,0,1,1,1,1,1,0,0,0,0],
[0,0,0,1,1,0,0,0,0,0,0,0,0,0,0,0,0,0,0,1,1,0,0,0,0],
[0,0,0,0,1,1,0,0,0,0,1,0,0,1,0,0,0,0,1,1,0,0,0,0,0],
[0,0,0,0,0,1,1,0,0,0,1,0,0,1,0,0,0,1,1,0,0,0,0,0,0],
[0,0,0,0,0,0,1,1,0,0,1,0,0,1,0,0,1,1,0,0,0,0,0,0,0],
[0,0,0,0,0,0,0,1,0,0,0,0,0,0,0,0,1,0,0,0,0,0,0,0,0],
[0,0,0,0,0,0,1,0,0,0,0,0,0,0,0,0,0,1,0,0,0,0,0,0,0],
[0,0,0,0,0,1,1,0,0,0,0,0,0,0,0,0,0,1,1,0,0,0,0,0,0],
[0,0,0,0,0,1,0,0,0,0,0,1,1,0,0,0,0,0,1,0,0,0,0,0,0],
[0,0,0,0,1,1,0,0,0,1,1,1,1,1,1,0,0,0,1,1,0,0,0,0,0],
[1,1,1,1,1,0,0,1,1,1,1,1,1,1,1,1,1,0,0,1,1,1,1,1,1],
[1,0,1,1,1,1,1,1,1,0,1,1,1,1,1,1,1,1,1,1,1,1,1,1,1],
[0,1,0,1,1,0,1,1,0,1,0,1,1,0,1,1,0,1,0,1,1,0,1,1,0],
[1,0,1,1,0,1,0,1,1,0,1,1,0,1,0,1,1,0,1,1,0,1,0,1,1],
[1,1,1,1,1,0,1,1,1,1,1,1,1,0,1,1,1,1,1,1,1,0,1,1,1],
],
"1210":[
[0,0,0,0,1,0,1,1,0,0,0,0,0,0,0,0,0,0,0,0,0,1,0,0,1],
[0,0,0,0,1,1,1,0,0,0,0,0,0,0,0,0,0,0,0,0,1,1,1,0,0],
[0,0,0,0,0,0,0,0,0,0,0,0,0,0,0,0,0,0,0,1,1,0,1,1,0],
[0,0,1,1,1,1,0,0,0,0,0,0,0,0,0,0,0,0,0,1,0,0,0,1,0],
[0,1,0,0,0,0,1,0,0,0,0,0,0,0,0,0,1,1,1,1,0,0,0,1,1],
[0,1,1,1,0,0,1,0,0,0,0,0,0,0,0,0,1,0,0,0,1,0,1,0,0],
[0,0,1,0,1,1,1,0,0,0,0,0,0,0,0,0,1,1,0,0,1,0,1,0,0],
[0,0,1,1,0,1,0,0,0,0,0,0,0,0,0,0,0,1,1,0,0,0,0,0,1],
[0,0,1,0,1,1,0,0,0,0,0,0,0,0,0,0,0,0,1,0,0,0,0,0,1],
[0,0,1,1,0,1,0,1,1,1,1,1,1,0,1,1,1,1,0,0,1,1,1,0,0],
[0,0,1,0,1,1,1,1,0,0,0,0,1,1,0,0,0,1,1,1,1,0,1,1,0],
[0,0,1,1,0,1,1,0,0,0,0,0,0,0,0,0,0,0,0,1,1,0,0,1,1],
[0,0,1,0,1,1,0,0,0,0,0,0,0,1,1,1,1,1,0,0,1,1,0,0,0],
[0,0,1,1,1,0,1,1,1,1,1,0,0,0,1,1,0,0,1,0,0,1,1,0,0],
[0,0,1,1,0,1,1,0,0,0,1,1,0,0,0,1,1,1,1,1,0,0,1,1,0],
[0,1,1,0,1,1,0,1,1,0,0,1,1,0,0,0,0,0,0,0,0,0,0,1,1],
[0,1,0,1,1,0,1,0,0,1,0,0,1,1,0,1,1,0,0,0,1,1,0,0,1],
[0,1,1,1,0,0,1,1,1,1,0,0,0,1,1,1,0,1,1,1,1,0,1,1,1],
[0,0,1,0,0,0,0,0,0,0,0,0,0,1,0,0,0,0,0,0,0,0,1,0,0],
[0,0,1,0,0,0,1,1,1,1,0,0,0,1,0,1,1,1,1,1,1,0,1,0,0],
[0,0,1,0,0,1,1,0,0,1,1,0,0,1,0,1,0,0,1,0,1,0,1,0,0],
[0,0,1,1,1,0,1,0,0,1,0,1,1,1,1,1,1,1,1,1,1,1,1,0,0],
[0,0,1,1,1,1,1,1,1,1,1,1,1,1,1,1,0,0,1,0,1,1,1,0,0],
[0,0,1,1,1,0,1,0,0,1,0,1,1,1,1,1,1,1,1,0,1,1,1,0,0],
[1,1,1,0,0,1,1,1,1,1,1,1,1,1,0,0,0,0,1,1,1,0,0,1,1],
],
"1211":[
[0,0,0,0,0,1,0,0,0,1,1,1,1,1,1,0,0,0,0,1,0,0,0,0,0],
[0,0,0,0,1,0,1,0,1,0,0,0,0,0,0,1,0,0,1,0,1,0,0,0,0],
[0,0,0,0,1,0,1,0,1,0,0,0,0,1,0,1,0,0,1,0,1,0,0,0,0],
[0,0,0,0,1,0,1,0,0,1,0,0,1,1,1,0,0,0,1,0,1,0,0,0,0],
[0,0,1,1,1,0,1,1,1,1,1,1,1,1,1,1,1,1,1,0,1,1,1,0,0],
[0,0,1,0,0,0,0,1,0,0,0,0,0,0,0,0,0,1,0,0,0,0,1,0,0],
[0,0,1,1,1,0,0,1,1,1,1,1,1,1,1,1,1,1,0,1,1,1,1,0,0],
[0,0,0,1,1,0,0,0,1,0,1,0,1,0,1,0,1,0,0,1,1,1,0,0,0],
[0,0,1,1,1,1,0,0,0,1,1,1,1,1,1,1,0,0,0,1,1,1,1,0,0],
[0,0,1,0,0,1,1,0,0,0,1,0,0,0,1,0,0,1,1,1,0,0,1,0,0],
[0,0,1,1,1,1,1,1,0,0,1,1,1,1,1,0,0,1,1,1,1,1,1,0,0],
[0,0,1,0,1,0,1,1,1,1,0,1,0,1,1,1,1,1,1,0,1,0,1,0,0],
[0,0,1,1,1,1,1,1,1,1,1,1,1,1,1,1,1,1,1,1,1,1,1,0,0],
[0,1,0,0,0,0,0,0,0,0,0,0,0,0,0,0,0,0,0,0,0,0,0,1,0],
[0,1,1,1,1,1,1,1,1,1,1,1,1,1,1,1,1,1,1,1,1,1,1,1,0],
[0,0,1,1,1,1,1,1,1,1,1,1,1,1,1,1,1,1,1,1,1,1,1,0,0],
[0,0,1,0,0,0,0,0,0,0,0,0,0,0,0,0,0,0,0,0,0,0,1,0,0],
[0,1,1,0,0,1,1,1,0,0,0,0,0,0,0,0,0,1,1,1,0,0,1,1,0],
[1,1,1,0,1,0,0,0,1,0,0,1,1,1,0,0,1,0,0,0,1,0,1,1,1],
[1,1,1,0,1,1,1,1,1,0,1,1,0,1,1,0,1,1,1,1,1,0,1,1,1],
[1,1,0,0,1,1,1,0,1,0,0,1,1,1,0,0,1,0,1,1,1,0,0,1,1],
[1,1,0,0,0,1,1,1,0,0,0,0,1,0,0,0,0,1,1,1,0,0,0,1,1],
[1,1,0,0,0,0,0,0,0,0,0,1,0,1,0,0,0,0,0,0,0,0,0,1,1],
[1,1,1,0,0,0,0,0,0,0,0,0,0,0,0,0,0,0,0,0,0,0,1,1,1],
[1,1,1,1,1,1,1,1,1,1,1,1,1,1,1,1,1,1,1,1,1,1,1,1,1],
],
"1212":[
[1,1,1,1,1,0,1,1,1,1,1,0,1,1,1,1,1,1,1,1,1,1,0,1,1],
[1,1,0,1,1,1,1,1,1,1,1,1,1,0,1,1,0,1,1,1,1,1,1,1,1],
[1,1,1,1,1,1,1,0,1,1,0,1,1,1,1,1,1,0,0,0,0,0,1,1,0],
[1,1,1,1,0,1,0,0,0,1,1,1,1,1,1,1,0,0,0,0,0,0,0,1,1],
[1,0,1,1,1,1,0,0,0,1,1,1,0,1,1,0,0,1,0,0,0,1,0,0,1],
[1,1,1,0,0,0,1,0,1,0,0,0,1,1,1,0,0,1,0,0,0,1,0,0,1],
[1,1,1,1,0,0,1,0,1,0,0,1,1,1,1,0,0,0,0,0,0,0,0,0,1],
[1,1,0,1,1,0,0,0,0,0,1,1,1,1,0,1,1,0,1,0,1,0,1,1,0],
[1,1,1,1,1,0,0,0,0,0,1,1,1,1,1,0,0,0,1,1,1,0,0,0,1],
[1,0,1,1,0,0,1,1,1,0,0,1,1,1,1,1,0,0,0,0,0,0,0,1,1],
[1,1,1,1,0,1,1,1,1,1,0,1,1,1,1,1,1,1,0,0,0,1,1,1,1],
[1,1,0,0,1,1,0,0,0,1,1,0,0,1,1,1,1,0,0,0,0,0,1,1,1],
[1,0,0,0,1,0,0,0,1,0,0,0,1,0,1,0,0,0,0,1,0,0,0,0,1],
[0,0,1,0,0,0,1,0,0,0,1,0,0,0,1,1,0,0,1,1,1,0,0,0,0],
[0,1,1,1,0,1,1,1,0,1,1,1,0,1,1,1,1,0,0,1,0,0,0,0,1],
[1,1,0,1,1,1,0,1,1,1,0,1,1,1,0,1,0,0,0,0,0,0,0,0,0],
[0,0,0,0,1,0,0,0,1,0,0,0,1,0,0,1,0,0,0,1,0,0,0,1,0],
[0,1,0,0,0,0,0,1,0,0,0,1,0,1,1,0,1,0,1,1,1,0,0,1,1],
[0,1,1,0,0,0,1,1,0,0,1,1,0,0,1,0,0,1,0,1,0,0,0,1,1],
[1,0,0,0,1,0,0,0,1,0,0,0,1,0,0,0,1,1,1,0,0,0,0,0,1],
[1,1,0,1,1,1,0,1,1,1,0,1,1,1,0,1,1,1,0,0,0,0,0,0,1],
[0,1,1,1,0,1,1,1,0,1,1,1,0,1,1,1,0,1,0,1,1,0,0,0,0],
[0,0,1,0,0,0,0,0,0,0,0,0,1,0,1,0,1,0,1,1,1,1,0,0,0],
[0,0,0,1,0,1,0,1,0,0,1,1,0,0,1,0,0,0,1,1,1,1,1,1,1],
[1,1,1,0,1,0,1,0,1,1,0,0,1,0,0,1,1,0,1,1,1,1,1,1,1],
],}