{"13101":[
[0,0,0,0,0,0,0,0,0,0,1,1,1,1,0,0,0,1,1,1,1,0,0,0,0],
[0,0,0,0,0,0,0,0,0,0,1,0,0,1,1,0,1,1,0,0,1,0,0,0,0],
[0,0,0,0,0,0,0,0,0,0,1,0,0,1,1,1,1,1,0,0,1,0,0,0,0],
[0,0,0,0,0,0,0,0,0,0,1,1,1,0,0,0,0,0,1,1,1,0,0,0,0],
[0,1,1,1,1,1,1,1,1,1,1,0,0,0,0,0,1,1,0,0,1,1,1,1,1],
[0,1,0,0,0,0,0,0,0,0,1,0,0,0,0,0,0,0,0,0,1,1,0,0,0],
[0,1,1,1,1,1,1,1,1,1,1,0,0,1,0,0,0,1,0,0,1,1,1,1,1],
[0,1,0,0,0,0,0,0,0,1,1,0,0,1,0,0,0,1,0,0,1,1,1,0,0],
[0,1,1,1,1,1,1,1,1,1,1,1,1,0,0,0,0,0,1,1,1,1,1,1,1],
[0,1,0,0,0,0,0,0,1,1,1,0,1,1,1,1,1,1,1,0,1,1,0,0,0],
[0,1,1,1,1,1,1,1,1,1,0,0,0,0,0,1,1,1,0,0,0,1,1,1,1],
[0,0,0,1,0,1,1,1,1,0,0,1,1,1,1,0,1,1,1,1,0,0,1,1,0],
[0,0,0,1,0,1,1,1,1,0,0,0,1,0,0,1,0,0,1,0,0,0,1,1,0],
[0,0,1,1,1,1,1,1,1,0,0,0,1,0,0,1,0,1,1,0,0,0,1,1,1],
[0,0,1,0,0,0,0,0,0,1,1,1,1,1,0,1,0,1,1,1,1,1,0,0,0],
[0,1,1,1,1,1,1,1,1,1,1,1,0,0,0,1,0,0,0,1,1,0,1,1,1],
[0,1,0,0,0,0,1,1,1,1,1,1,1,1,1,1,1,1,1,1,0,0,1,1,0],
[1,1,1,1,1,1,1,1,1,1,1,1,0,0,1,1,1,1,1,1,0,1,1,1,1],
[1,0,0,0,0,0,0,0,0,1,1,0,0,0,1,0,0,1,1,0,0,1,0,0,0],
[1,1,1,1,1,1,1,1,1,1,1,0,0,1,0,1,0,1,1,0,1,1,1,1,1],
[0,1,0,1,0,0,0,1,0,1,1,0,1,1,0,1,0,0,1,0,1,0,1,0,0],
[0,1,0,1,0,0,0,1,0,1,1,0,1,1,0,1,0,1,0,0,1,0,1,0,0],
[0,1,0,1,1,1,1,1,1,1,1,0,0,0,1,1,0,0,0,1,1,1,1,1,1],
[1,1,0,1,1,1,1,1,1,1,1,1,1,1,1,1,1,1,1,1,1,1,1,1,1],
[1,1,1,1,1,1,1,1,1,1,1,1,1,1,1,1,1,1,1,1,1,1,1,1,1],
],
"13102":[
[0,0,1,1,1,0,0,0,1,1,1,0,0,0,0,0,0,0,1,1,1,1,1,0,0],
[0,1,1,0,1,1,0,1,1,0,1,1,0,0,0,0,1,1,1,0,0,0,1,1,0],
[0,1,0,1,0,1,1,1,0,1,0,1,0,0,1,1,1,0,0,0,1,0,0,1,0],
[1,1,1,0,1,1,0,1,1,0,1,1,0,1,1,0,1,0,1,1,1,1,0,1,0],
[1,0,1,1,1,0,1,0,1,1,0,0,0,1,0,1,0,1,0,1,1,0,1,1,0],
[0,1,0,0,1,1,0,1,0,1,1,0,0,1,0,1,0,1,1,0,1,1,1,0,0],
[1,0,1,1,1,1,0,1,1,0,1,0,0,1,1,1,1,1,1,1,0,0,0,0,0],
[1,0,1,1,1,1,1,0,0,1,1,0,1,1,0,0,0,0,0,1,1,0,0,0,0],
[0,1,0,1,1,0,1,1,0,1,0,1,1,0,0,0,1,1,0,0,1,0,0,0,0],
[0,1,0,1,0,1,0,1,1,0,0,1,0,0,0,0,0,1,1,0,1,0,0,0,0],
[0,0,1,1,1,0,1,0,1,1,0,1,0,1,0,0,0,1,1,0,1,0,0,0,0],
[0,1,1,0,1,1,0,1,0,1,0,1,0,1,0,1,1,1,0,0,1,0,0,0,0],
[0,1,0,1,0,1,1,0,1,0,0,1,1,0,0,0,0,0,0,1,1,0,0,0,0],
[0,1,1,0,1,0,1,1,1,0,0,0,1,1,1,1,1,1,1,1,1,1,0,0,0],
[0,0,1,1,0,1,1,0,1,1,1,1,1,0,0,0,1,1,1,1,0,1,0,0,0],
[0,0,1,0,1,1,0,1,0,1,0,0,0,0,0,0,0,0,1,0,0,1,0,0,0],
[1,1,1,0,1,1,1,0,1,1,0,0,0,0,0,1,1,1,0,1,0,1,1,0,0],
[1,0,1,0,1,0,1,1,0,1,1,1,0,0,1,1,1,1,1,1,0,0,1,0,0],
[1,0,0,1,1,1,1,0,0,1,0,1,1,1,0,0,0,0,1,1,1,0,1,1,0],
[1,1,0,0,0,0,0,0,1,1,0,0,1,0,0,0,1,0,1,1,1,0,1,1,1],
[1,0,1,1,1,1,1,1,0,1,0,0,1,1,0,0,1,1,0,1,0,0,1,0,1],
[1,0,0,0,0,1,1,1,0,1,0,1,1,0,0,0,1,1,0,0,0,0,1,0,1],
[0,1,0,0,1,1,1,0,1,0,1,1,0,0,1,1,1,1,0,0,0,1,1,1,0],
[1,1,0,0,0,0,0,0,1,1,1,0,0,0,0,0,0,0,1,1,1,1,1,1,1],
[1,1,1,1,1,1,1,1,1,1,1,1,1,1,1,1,1,1,1,1,1,1,1,1,1],
],
"13103":[
[1,0,1,1,1,1,1,1,1,1,1,1,1,1,1,0,1,1,1,1,0,0,1,1,1],
[1,0,1,0,0,0,0,0,0,0,1,1,1,0,1,0,1,1,0,1,1,0,0,0,1],
[1,0,1,0,0,0,1,1,1,1,1,0,0,1,1,0,1,0,1,0,1,1,0,0,1],
[1,0,0,1,1,1,1,0,0,0,0,1,1,1,0,0,1,0,1,1,0,1,1,0,0],
[1,1,0,0,1,0,0,0,0,1,1,0,1,0,0,0,1,0,1,1,0,0,1,1,0],
[0,1,0,0,1,0,0,1,1,1,0,1,1,0,1,0,1,0,0,1,1,0,0,1,1],
[0,0,0,0,1,0,1,1,0,0,1,1,0,1,1,0,1,0,0,0,1,0,0,0,1],
[1,1,0,0,1,1,1,0,0,1,1,0,0,1,0,0,1,0,0,1,1,1,1,1,1],
[1,0,0,1,0,0,1,1,1,1,0,0,1,1,0,0,1,0,1,1,0,1,0,0,0],
[1,1,0,1,0,0,0,0,0,0,0,1,1,0,1,0,1,1,1,1,0,1,0,0,1],
[0,1,0,1,1,0,0,0,0,0,0,0,0,0,1,0,0,0,0,1,1,1,0,0,1],
[0,1,1,0,1,1,0,0,0,0,0,1,1,0,0,0,0,1,1,0,0,0,0,1,1],
[0,0,1,0,0,1,1,1,0,0,1,0,1,1,0,0,1,1,0,1,0,1,1,1,0],
[0,0,1,1,0,0,0,0,0,0,1,0,0,1,1,1,1,0,0,1,0,0,0,0,0],
[0,0,0,0,0,1,1,1,0,0,1,1,1,1,0,0,1,1,1,1,0,0,0,0,0],
[0,0,0,0,1,1,0,1,1,0,1,1,0,0,0,0,0,0,1,1,0,0,0,0,0],
[0,0,0,1,1,0,0,0,1,1,1,0,0,1,0,0,1,0,0,1,1,1,1,1,1],
[0,0,0,1,0,0,1,0,0,1,0,0,0,1,0,0,1,0,0,0,1,0,0,0,1],
[0,1,0,1,1,0,1,0,1,1,0,1,0,0,1,1,0,1,1,0,1,0,0,0,0],
[0,1,0,0,1,0,1,1,0,1,0,1,1,1,0,0,0,0,0,0,1,0,1,0,0],
[0,1,1,0,1,0,1,1,0,1,1,0,0,1,1,1,0,0,0,1,1,1,1,1,0],
[0,0,1,0,1,1,0,1,1,1,1,1,1,0,0,0,0,1,1,1,0,0,1,1,0],
[1,0,1,1,0,1,0,0,1,1,1,1,1,1,1,1,1,1,1,0,0,1,0,1,1],
[1,1,0,0,0,1,1,0,1,1,0,1,1,1,1,1,1,1,1,1,1,0,1,1,1],
[0,1,1,1,0,0,1,1,0,0,0,0,0,1,1,1,1,1,1,1,1,1,1,1,1],
],
"13104":[
[1,1,1,0,0,0,0,1,1,0,1,1,1,0,0,1,0,0,1,1,1,0,1,1,0,0,0,1,1,1],
[1,0,1,0,0,0,0,0,1,1,0,1,1,1,0,1,0,1,1,1,0,1,1,0,0,0,0,1,0,1],
[1,0,1,0,0,0,0,0,0,1,0,0,1,1,0,1,0,1,1,0,0,1,0,0,0,0,0,1,0,1],
[1,0,1,0,0,0,0,0,0,0,0,0,0,0,0,0,0,0,0,0,0,0,0,0,0,0,0,1,0,1],
[1,0,1,1,1,1,1,1,1,1,1,1,1,1,1,1,1,1,1,1,1,1,1,1,1,1,1,1,0,1],
[1,0,1,0,1,0,0,0,1,1,0,0,0,0,0,0,0,0,0,1,1,1,0,0,0,1,0,1,0,1],
[1,0,1,1,1,0,0,0,1,1,1,1,1,1,1,1,1,1,1,1,1,1,0,0,0,1,1,1,0,1],
[1,1,1,0,1,0,0,0,1,0,0,0,0,0,0,0,0,0,0,0,0,1,0,0,0,1,0,1,1,1],
[1,1,1,0,1,1,0,1,1,0,1,1,1,1,0,0,1,1,1,1,0,1,1,0,1,1,0,1,1,1],
[1,1,1,0,0,1,0,1,0,0,1,0,0,1,0,0,1,0,0,1,0,0,1,0,1,0,0,1,1,1],
[1,1,1,0,0,1,0,1,0,0,1,1,0,1,1,1,1,0,1,1,0,0,1,0,1,1,0,1,1,1],
[1,1,1,0,1,1,0,1,1,0,0,1,1,0,0,0,0,1,1,0,0,1,1,0,0,1,0,1,1,1],
[0,0,0,0,1,0,0,0,1,0,1,1,0,0,0,0,0,0,1,1,0,1,0,0,0,1,0,0,0,0],
[0,0,0,1,1,0,0,0,1,1,1,0,0,1,0,0,1,0,0,1,1,1,0,0,0,1,1,0,0,0],
[0,0,0,1,0,0,1,1,0,1,1,0,0,1,0,0,1,0,0,1,1,0,1,1,0,0,1,0,0,0],
[0,0,0,1,0,0,1,1,1,1,1,0,1,0,1,1,0,1,0,1,1,1,1,1,0,0,1,0,0,0],
[0,0,0,1,0,0,1,0,0,0,1,1,0,0,0,0,0,0,1,1,0,0,0,1,0,0,1,0,0,0],
[0,0,0,1,1,0,0,0,0,1,1,1,1,1,1,1,1,1,1,1,1,0,0,0,0,1,1,0,0,0],
[0,0,0,0,1,1,0,0,0,0,0,0,0,0,1,1,1,0,0,0,0,0,0,0,1,1,0,0,0,0],
[0,0,0,0,0,1,1,0,0,0,0,0,0,0,0,1,0,0,0,0,0,0,0,1,1,0,0,0,0,0],
[0,0,0,0,0,0,1,1,1,0,1,0,0,0,0,0,0,0,0,0,0,1,1,1,0,0,0,0,0,0],
[0,0,0,0,0,0,0,1,1,0,1,0,0,0,1,1,0,0,0,1,0,1,1,0,0,0,0,0,0,0],
[0,0,0,0,0,0,0,0,1,0,1,1,0,0,1,1,0,0,0,1,0,1,0,0,0,0,0,0,0,0],
[0,0,0,0,0,0,0,0,1,0,1,1,1,1,0,1,1,1,1,1,0,1,0,0,0,0,0,0,0,0],
[0,0,0,0,0,0,0,0,1,0,1,0,0,0,1,0,0,1,1,0,0,1,0,0,0,0,0,0,0,0],
[1,1,1,0,0,1,1,1,1,1,0,1,0,0,1,1,0,0,0,0,1,1,1,1,1,0,0,1,1,1],
[1,0,1,1,1,1,0,1,0,1,0,1,1,1,1,1,1,1,1,0,1,0,1,0,1,1,1,1,0,1],
[1,0,0,0,0,0,0,1,0,1,0,1,0,1,1,0,1,1,0,1,1,0,1,0,0,0,0,0,0,1],
[1,0,1,1,1,1,0,1,0,1,1,0,0,0,1,1,0,0,0,1,0,0,1,0,1,1,1,1,0,1],
[1,1,1,0,0,1,1,1,0,0,1,0,0,1,1,1,1,1,0,1,0,0,1,1,1,0,0,1,1,1],
],
"13105":[
[0,0,0,0,0,0,0,0,0,0,0,0,0,0,0,0,0,0,0,0,0,0,0,0,0,0,0,0,0,0],
[0,0,0,0,0,0,1,0,0,0,0,0,0,0,0,0,1,1,1,0,0,1,1,1,1,0,0,0,1,1],
[0,0,0,0,0,0,1,0,0,0,0,0,0,0,0,1,1,0,1,0,1,1,0,0,1,1,1,1,1,1],
[0,0,0,0,0,0,1,1,1,0,0,0,0,0,0,1,0,0,1,1,1,0,0,0,1,0,0,1,1,0],
[0,0,0,0,0,0,1,0,1,1,0,0,0,1,1,1,0,0,0,0,1,0,0,1,0,0,1,1,0,0],
[0,0,0,0,0,1,1,1,0,1,0,1,1,1,0,1,0,0,0,0,0,0,0,0,1,1,0,1,0,0],
[0,0,0,0,0,1,0,1,0,1,1,0,0,0,0,1,0,1,1,0,0,1,0,0,1,1,1,0,0,1],
[0,0,0,0,0,1,0,1,1,0,1,0,0,0,1,1,0,0,0,0,0,0,1,1,0,1,0,0,1,1],
[0,0,1,1,0,1,0,0,1,0,1,1,0,0,1,0,0,1,0,0,0,1,1,1,0,1,0,1,1,1],
[1,1,1,0,0,1,0,0,1,1,0,1,0,0,1,0,0,1,0,0,0,1,1,1,0,1,0,0,0,1],
[0,0,0,0,1,1,0,0,0,1,0,1,1,0,1,1,0,0,0,0,1,1,1,0,1,1,0,0,1,0],
[0,0,0,0,1,0,0,0,0,1,1,0,1,0,0,1,1,0,0,1,1,0,0,0,1,1,0,1,1,1],
[0,0,0,0,1,0,0,0,0,0,1,0,1,0,0,0,1,1,1,0,0,0,0,1,0,1,1,0,1,1],
[0,1,1,0,1,0,0,0,0,0,1,1,0,1,1,1,1,0,1,1,0,0,0,1,0,0,1,1,0,1],
[1,1,0,0,1,0,0,1,1,0,0,1,1,1,0,0,0,1,0,0,0,1,1,1,1,0,1,1,0,1],
[1,1,1,0,1,0,0,0,1,1,1,1,0,0,0,1,1,1,0,0,0,0,0,1,1,0,0,1,0,0],
[0,1,0,1,1,0,0,0,0,1,1,1,0,0,1,1,1,0,0,0,0,0,0,1,0,1,0,1,0,0],
[1,0,0,1,0,1,1,1,1,0,0,1,1,0,0,0,0,1,1,1,0,0,0,0,1,1,0,1,1,0],
[1,1,0,1,0,0,0,1,1,1,1,0,1,1,1,1,1,1,1,0,0,0,1,0,1,1,0,0,1,1],
[0,0,0,1,0,0,0,0,0,0,1,1,0,1,1,0,1,1,1,0,0,0,1,1,1,1,1,0,0,1],
[1,0,0,1,0,0,0,1,1,0,0,1,0,1,1,1,0,1,0,0,1,0,1,1,0,1,1,1,0,1],
[1,1,0,1,0,1,1,1,1,1,0,1,1,1,1,1,0,1,0,0,1,0,0,1,0,0,1,1,0,1],
[1,1,0,1,0,0,1,1,1,0,0,1,1,1,0,0,1,1,0,0,1,1,0,0,1,1,1,0,0,1],
[1,0,1,1,0,0,1,0,0,1,0,1,1,0,0,0,0,0,1,0,1,1,1,1,0,1,0,0,1,1],
[0,0,1,0,0,1,1,1,0,1,0,1,1,0,0,1,1,1,1,0,0,1,1,1,1,0,0,0,1,1],
[1,0,1,0,1,1,1,1,0,0,1,1,1,0,1,0,1,1,0,1,0,0,1,1,0,0,1,1,1,1],
[1,0,1,0,0,0,1,0,1,0,1,1,0,0,0,0,1,0,1,1,0,0,1,1,0,1,1,1,1,1],
[1,1,0,0,0,1,0,0,1,1,0,0,0,0,1,1,1,0,1,1,0,1,1,1,0,1,1,1,0,1],
[1,1,1,1,0,0,0,1,1,1,0,0,1,1,0,1,1,0,0,1,0,0,0,0,0,1,1,1,1,0],
[1,1,0,0,0,1,1,1,1,1,0,0,0,1,1,1,1,1,1,1,1,1,1,1,1,1,1,0,0,1],
],
"13106":[
[1,1,1,1,1,1,1,1,1,0,0,0,1,0,0,0,0,0,1,1,1,0,0,0,0,0,0,0,0,0],
[1,1,1,1,1,1,0,0,0,0,0,1,1,1,0,0,0,0,1,0,1,0,0,0,0,0,1,1,1,0],
[1,1,1,1,0,0,0,0,0,0,1,1,0,1,1,0,1,1,1,0,1,1,1,0,0,1,0,0,0,1],
[1,1,1,0,0,0,1,1,1,1,0,1,1,1,0,1,1,0,0,1,1,0,1,1,0,1,0,1,1,1],
[1,1,1,0,0,1,1,0,0,1,1,0,1,0,0,1,0,1,0,1,1,1,0,1,0,1,0,1,1,1],
[1,1,0,0,1,1,0,0,0,0,1,0,1,0,0,1,0,1,1,0,1,1,0,1,1,1,0,0,1,1],
[1,1,0,0,1,0,0,1,1,1,1,1,0,0,0,1,0,0,1,1,1,0,0,1,1,1,0,1,0,1],
[1,0,0,1,1,0,1,1,1,0,0,1,0,0,0,0,1,0,0,0,0,0,1,1,1,1,0,0,1,1],
[0,0,0,1,0,0,1,0,0,0,0,1,0,0,1,1,1,1,1,1,1,1,1,1,1,1,1,1,1,1],
[0,0,0,1,0,1,1,0,1,1,1,1,0,0,1,0,0,0,0,0,0,0,0,0,0,0,0,0,0,0],
[0,0,0,1,0,1,0,1,1,1,1,0,0,0,1,1,1,1,1,1,1,1,1,1,1,1,1,1,1,1],
[0,0,0,1,0,1,0,1,1,0,0,0,0,0,0,0,0,0,0,1,1,1,1,1,1,1,1,1,1,1],
[0,0,0,1,1,1,1,1,1,0,0,0,0,0,0,0,0,0,0,1,0,0,1,1,1,1,1,1,1,1],
[0,1,1,1,0,0,0,0,1,1,0,0,0,0,0,0,0,0,0,0,0,0,1,1,1,0,1,1,1,1],
[0,1,0,0,1,1,0,0,0,1,1,0,0,1,1,1,0,0,0,0,0,0,0,0,1,0,1,1,1,1],
[1,1,0,1,1,0,0,0,0,0,1,0,1,1,0,1,0,0,0,0,0,0,0,0,0,0,1,1,1,1],
[1,0,1,1,0,0,0,0,1,0,1,1,1,0,0,1,1,1,1,1,1,1,1,0,0,0,0,1,0,1],
[1,0,1,1,1,0,0,0,1,0,0,1,1,0,0,1,1,0,0,0,0,0,1,1,1,0,0,0,0,1],
[1,0,0,1,1,1,1,0,0,0,0,1,1,0,1,0,0,1,0,1,0,1,0,0,1,1,0,0,0,1],
[1,1,0,0,0,0,0,0,0,0,1,1,0,1,0,1,1,0,1,1,1,1,0,1,0,1,0,0,0,1],
[0,1,1,1,1,1,1,1,1,1,1,1,1,1,0,0,1,1,1,1,1,0,1,1,0,1,0,0,0,1],
[0,1,0,0,0,0,0,0,0,0,1,1,1,1,0,0,0,0,0,1,1,1,1,0,1,1,0,0,0,0],
[1,1,0,0,1,0,0,0,1,0,0,1,1,1,1,0,0,0,0,0,0,0,0,1,1,0,0,0,0,0],
[1,0,0,1,1,0,0,0,1,1,1,0,0,1,1,1,1,1,1,1,1,1,1,1,1,1,0,0,0,0],
[1,0,1,1,0,0,1,0,0,1,1,1,0,0,0,0,0,1,0,0,0,0,0,0,0,0,0,0,0,0],
[1,0,1,1,1,0,1,1,1,0,0,0,1,1,0,0,1,1,0,1,1,1,1,1,1,1,1,1,1,1],
[1,0,1,1,0,1,0,1,1,1,1,1,0,0,0,1,1,0,1,1,0,0,0,0,0,0,0,0,0,0],
[1,0,1,1,1,0,1,1,1,1,1,0,1,1,1,1,0,1,1,0,0,1,0,1,0,0,1,1,1,1],
[1,0,0,1,1,1,1,1,1,0,1,0,1,0,0,0,1,1,0,0,1,1,1,0,1,0,0,1,1,1],
[0,1,0,0,0,1,1,1,1,1,0,0,0,1,0,1,1,0,0,1,0,1,1,1,1,1,1,1,1,1],
],
"13107":[
[0,0,0,0,0,0,0,0,0,0,0,1,1,1,1,1,1,1,0,0,0,0,0,0,0],
[0,0,0,0,0,0,0,0,0,1,1,1,1,0,0,0,0,1,1,0,0,0,0,0,0],
[0,0,0,0,0,0,0,0,1,1,1,0,0,0,0,1,0,0,1,1,0,0,0,0,0],
[0,0,0,0,0,0,0,1,1,0,0,0,0,0,0,1,1,1,1,1,1,0,0,0,0],
[0,0,0,0,0,0,1,0,0,0,0,0,1,0,1,1,0,0,0,0,1,1,0,0,0],
[0,0,0,0,0,1,1,0,0,0,1,0,1,1,1,0,0,0,1,1,0,1,1,0,0],
[0,0,0,0,0,1,0,0,0,0,0,1,1,1,0,0,0,1,1,1,0,0,1,0,0],
[0,0,0,0,1,1,0,0,0,1,1,1,1,0,0,1,0,0,1,1,0,0,1,1,0],
[0,0,0,1,1,0,0,1,0,0,1,0,0,0,1,1,1,0,1,1,1,1,0,1,0],
[0,0,0,1,0,0,0,0,1,1,1,0,1,1,1,0,0,0,0,0,1,0,0,1,1],
[0,0,1,1,0,0,1,0,1,1,0,0,1,1,0,0,0,1,1,0,0,1,0,0,1],
[0,0,1,0,0,0,0,1,1,0,0,1,1,0,0,0,1,1,0,0,1,1,1,0,1],
[0,1,1,0,0,1,0,1,1,0,1,0,1,1,0,0,0,0,1,1,0,1,1,0,1],
[0,1,1,0,0,0,1,1,0,0,1,0,1,0,0,1,1,1,1,1,0,1,0,0,1],
[0,1,0,0,1,1,1,1,0,0,1,0,0,0,0,0,1,1,0,1,1,1,1,0,1],
[1,1,0,0,0,1,1,0,0,0,0,0,0,0,1,0,0,0,0,1,1,1,0,1,1],
[1,1,0,1,1,1,1,0,0,1,0,0,1,1,1,1,1,0,1,1,1,0,0,1,1],
[1,1,0,0,1,1,0,0,1,1,1,0,0,1,0,0,1,1,1,1,1,1,0,1,1],
[1,1,0,1,1,0,0,0,1,1,0,1,1,1,1,1,1,1,0,1,0,0,1,1,1],
[1,1,0,0,1,0,1,0,1,1,1,1,1,0,0,1,1,0,0,0,1,1,1,1,1],
[0,1,1,0,1,0,1,1,1,1,1,1,0,1,0,0,0,0,1,1,1,1,1,1,0],
[0,0,1,0,0,1,1,1,1,0,0,0,0,0,0,1,1,1,1,1,1,1,1,1,0],
[0,0,1,0,1,1,1,0,0,0,1,1,1,1,1,1,1,1,1,1,1,1,1,0,0],
[0,0,1,0,0,0,0,1,1,1,1,1,1,1,1,1,1,1,1,1,1,0,0,0,0],
[0,0,1,1,1,1,1,1,1,1,1,1,1,1,1,1,1,1,1,1,0,0,0,0,0],
],
"13108":[
[0,0,0,0,0,0,0,0,0,0,0,0,0,0,0,0,0,0,1,1,0,0,0,0,0],
[0,0,0,0,0,0,0,0,0,0,0,0,0,0,0,1,1,1,1,0,1,0,0,0,0],
[0,0,0,0,0,0,0,0,0,0,0,0,0,1,1,1,0,0,0,1,1,1,0,0,0],
[0,0,0,0,0,0,0,0,1,1,1,1,1,1,0,0,1,1,1,0,0,1,0,0,0],
[0,0,0,0,0,0,1,1,1,0,0,0,0,1,1,0,0,0,1,1,1,1,0,0,0],
[0,0,0,0,0,1,1,0,0,1,1,1,0,0,1,1,1,0,0,0,1,1,0,0,0],
[0,0,0,0,0,1,0,0,1,1,1,0,0,0,0,0,1,1,1,1,1,1,1,0,0],
[0,0,0,0,1,1,0,1,1,0,1,0,0,1,1,0,0,0,0,1,1,0,1,0,0],
[0,0,0,0,1,0,0,1,1,1,0,0,0,0,0,1,1,1,0,0,0,0,1,0,0],
[0,0,0,0,1,0,1,0,1,0,0,0,1,0,0,1,1,1,1,1,0,0,1,0,0],
[0,0,0,0,1,0,1,0,1,1,0,0,1,0,0,1,1,1,0,1,0,1,1,0,0],
[0,0,0,1,1,0,1,0,0,0,0,0,0,1,1,1,1,1,1,0,0,1,1,1,0],
[0,0,0,1,0,0,1,0,0,1,0,1,0,1,1,1,1,0,0,0,1,0,0,1,0],
[0,0,0,1,0,0,1,1,0,1,1,0,1,1,1,0,1,1,0,1,1,1,0,1,1],
[0,0,1,1,0,1,1,1,0,0,1,1,1,1,0,1,0,0,0,1,1,0,1,0,1],
[0,0,1,0,0,1,1,1,0,0,0,1,1,1,0,0,0,1,1,1,0,0,1,0,1],
[0,1,1,0,1,0,1,1,1,0,1,1,1,0,0,1,1,1,1,1,0,1,1,0,1],
[0,1,0,0,1,1,1,1,0,1,0,0,0,1,1,1,1,0,1,0,0,1,0,1,1],
[1,1,0,0,1,1,1,0,0,0,1,1,1,1,1,1,0,1,0,0,1,1,0,1,1],
[1,0,1,1,1,0,0,0,1,1,1,1,1,1,0,0,0,0,0,1,1,0,1,1,1],
[1,0,0,0,0,1,1,1,1,1,1,1,1,0,1,0,1,1,1,0,0,1,1,1,0],
[1,1,1,1,1,0,0,1,1,1,1,1,1,1,1,1,1,1,0,1,1,1,1,0,0],
[0,1,1,1,1,1,1,0,0,1,1,1,1,1,0,0,0,0,1,1,1,1,0,0,0],
[0,0,0,1,1,1,1,1,0,0,0,0,0,0,1,1,1,1,1,1,1,0,0,0,0],
[0,0,0,0,0,1,1,1,1,1,1,1,1,1,1,1,1,1,1,1,0,0,0,0,0],
],
"13109":[
[1,1,1,1,1,1,1,1,1,1,0,0,0,0,0,0,0,0,0,0,1,1,1,1,0],
[1,1,1,1,1,1,1,1,0,0,0,0,0,0,0,0,0,0,1,1,1,0,0,0,1],
[1,1,1,1,1,1,0,0,0,0,0,0,0,0,0,0,1,1,1,0,0,1,1,1,1],
[1,1,1,1,0,0,0,0,0,0,0,1,1,1,1,1,1,0,0,1,1,0,1,1,1],
[1,1,0,0,0,0,0,0,1,1,1,1,0,1,0,0,0,1,0,0,1,1,1,0,1],
[1,0,0,0,1,1,0,1,1,1,0,0,0,1,1,1,0,0,1,1,0,0,0,1,1],
[0,0,0,1,1,1,1,1,0,0,1,1,0,0,1,1,1,0,0,0,1,1,1,1,0],
[0,0,0,1,0,0,1,1,1,0,0,0,1,1,0,0,1,1,1,0,0,1,1,1,0],
[0,0,1,1,1,1,0,0,0,1,1,0,0,1,1,0,0,0,1,1,1,1,1,1,0],
[0,0,1,0,0,0,1,1,1,0,1,1,0,0,0,1,1,0,0,0,1,1,1,1,1],
[0,0,1,1,1,0,0,0,1,1,0,0,1,1,0,0,1,1,1,0,0,0,0,0,1],
[0,1,1,1,1,1,1,0,0,0,1,1,0,1,1,0,0,0,1,1,0,0,0,1,1],
[0,1,0,0,0,1,1,1,1,0,0,0,1,0,0,1,1,0,1,1,1,1,1,1,0],
[0,1,1,1,1,0,0,0,1,1,1,0,0,1,1,0,1,1,0,1,1,1,1,0,0],
[0,1,1,0,0,1,1,1,0,0,1,1,1,0,0,1,0,0,1,1,1,1,1,0,0],
[0,1,1,1,1,0,0,0,1,1,0,0,1,1,0,0,1,0,0,1,1,1,1,0,0],
[1,1,0,1,1,1,1,1,0,0,1,1,0,0,1,0,0,1,0,0,1,1,1,0,0],
[1,0,0,0,0,0,1,1,1,1,0,0,1,0,1,1,1,1,1,0,0,1,1,0,0],
[1,1,1,1,1,0,0,0,0,1,1,1,1,1,0,1,1,1,1,1,0,0,1,0,0],
[0,0,1,0,0,1,1,1,1,0,0,1,1,1,1,0,1,1,1,1,1,0,1,0,0],
[0,0,1,0,0,0,0,1,1,1,1,0,0,1,1,1,0,1,1,1,1,1,1,0,0],
[0,1,1,1,1,1,1,1,0,0,1,1,1,1,1,1,1,1,1,1,0,0,0,0,0],
[0,1,0,0,1,1,0,0,1,1,1,0,0,0,0,0,0,0,0,0,0,0,0,0,0],
[0,1,1,0,0,0,1,1,1,0,0,0,0,0,0,0,0,0,0,0,0,0,0,0,0],
[0,0,1,1,1,1,1,0,0,0,0,0,0,0,0,0,0,0,0,0,0,0,0,0,0],
],
"13110":[
[0,0,0,0,0,0,0,0,0,0,0,0,0,0,0,0,0,0,0,1,1,1,1,1,0,0,0,0,0,0],
[0,0,0,0,0,1,1,1,0,0,0,0,0,0,0,0,0,1,1,1,0,0,0,1,1,1,0,0,0,0],
[0,0,0,0,1,0,0,1,1,1,1,1,1,0,0,0,1,1,0,0,1,1,0,1,0,1,1,0,0,0],
[0,0,0,0,1,0,1,0,0,0,1,0,1,1,1,1,1,1,1,1,1,1,1,0,0,0,1,1,0,0],
[0,0,0,1,1,1,0,0,1,1,0,0,1,0,1,0,1,1,1,1,0,0,0,0,1,1,0,1,0,0],
[0,0,0,1,0,1,1,1,1,0,0,1,1,0,1,0,0,1,0,1,0,1,1,1,1,0,0,1,0,0],
[0,0,1,0,1,1,1,0,0,0,1,1,0,1,1,0,0,1,1,1,1,1,0,1,0,0,0,1,1,0],
[0,1,1,1,1,0,0,0,1,1,0,0,1,1,0,0,1,0,1,1,0,0,1,0,1,1,1,0,1,0],
[1,1,0,0,0,0,1,1,1,0,0,1,1,0,0,1,0,1,1,1,1,1,1,1,1,0,0,0,1,1],
[1,0,0,0,1,1,1,0,0,1,1,1,0,0,1,1,0,1,0,1,1,1,0,0,0,0,1,1,0,1],
[1,0,1,1,1,1,1,1,1,1,0,0,0,1,1,0,1,0,1,1,0,0,0,1,1,1,0,1,0,1],
[1,1,0,1,0,1,1,1,1,0,0,1,1,0,0,1,0,1,0,1,1,1,1,1,1,0,1,0,0,1],
[0,1,0,0,1,1,1,0,0,1,1,1,0,0,1,1,0,1,0,1,1,1,0,0,0,0,0,1,1,1],
[0,1,1,1,1,0,0,0,1,1,0,0,0,1,1,0,1,0,1,0,1,1,1,1,0,1,1,1,0,1],
[1,1,0,0,0,0,1,1,0,0,0,1,1,0,0,1,1,0,1,0,1,1,1,1,1,0,0,0,0,1],
[1,0,0,1,1,1,1,0,1,0,1,1,0,0,1,1,0,1,0,1,1,1,0,0,0,0,1,1,1,1],
[1,0,1,0,1,1,1,1,1,1,0,0,1,1,0,0,1,0,1,0,1,0,0,1,1,1,0,0,1,0],
[1,1,0,1,0,1,1,1,1,0,0,1,0,0,0,1,1,0,1,0,1,1,1,1,1,0,0,1,1,0],
[0,1,0,0,0,1,1,0,0,1,1,1,0,1,1,1,0,1,0,1,1,1,1,0,0,1,1,1,1,0],
[0,1,1,0,1,1,0,0,1,1,1,0,1,1,1,0,1,0,0,1,1,1,1,1,1,1,0,0,1,0],
[0,0,1,1,0,0,1,1,1,1,1,1,1,0,0,0,1,0,1,0,1,1,1,1,0,0,0,1,1,0],
[0,0,1,0,1,1,1,1,0,1,1,1,0,0,1,1,0,0,1,0,0,1,0,0,0,1,1,1,0,0],
[0,0,1,1,0,0,0,0,0,1,1,0,0,1,1,0,1,1,0,1,0,1,1,1,1,0,0,1,0,0],
[0,0,0,1,1,1,1,0,1,0,0,1,1,1,1,1,1,1,1,1,0,1,1,1,1,0,1,1,0,0],
[0,0,0,0,0,0,1,1,1,0,1,0,1,0,1,1,0,1,1,0,0,1,1,1,1,1,0,1,0,0],
[0,0,0,0,0,0,0,0,1,1,1,1,0,0,1,0,1,0,1,0,1,0,0,1,0,0,1,1,0,0],
[0,0,0,0,0,0,0,0,0,0,0,1,1,1,1,1,1,1,1,0,1,1,0,1,1,0,1,0,0,0],
[0,0,0,0,0,0,0,0,0,0,0,0,0,0,0,0,0,0,1,1,1,0,0,0,1,1,1,0,0,0],
[0,0,0,0,0,0,0,0,0,0,0,0,0,0,0,0,0,0,0,0,1,1,1,0,1,1,0,0,0,0],
[0,0,0,0,0,0,0,0,0,0,0,0,0,0,0,0,0,0,0,0,0,0,1,1,1,0,0,0,0,0],
],
"13111":[
[0,0,0,0,0,0,0,0,1,1,1,1,1,1,1,1,1,1,0,0,0,0,0,0,0,0,0,0,0,0],
[0,0,0,0,0,0,1,1,1,0,0,0,0,0,0,0,0,1,1,1,1,0,0,0,0,0,0,0,0,0],
[0,0,0,0,1,1,1,1,1,1,1,1,1,1,0,1,1,0,0,0,1,1,1,1,0,0,0,0,0,0],
[0,1,1,1,1,0,0,0,0,0,0,0,0,1,1,1,1,1,0,1,0,0,0,1,1,0,0,0,0,0],
[1,1,0,0,0,0,1,0,1,1,1,0,0,0,0,0,0,0,1,1,1,0,1,0,1,1,0,0,0,0],
[1,0,0,0,1,1,1,0,0,1,0,0,1,1,0,1,1,0,0,0,0,1,1,1,0,1,1,0,0,0],
[0,0,1,0,0,1,0,1,0,1,1,0,1,1,0,0,1,1,1,0,0,0,0,1,1,0,1,0,0,0],
[0,1,1,1,0,0,1,1,0,1,1,1,1,0,0,1,1,0,0,0,0,1,0,1,0,0,1,1,0,0],
[0,0,1,1,0,1,1,1,1,1,1,1,1,1,0,1,0,1,0,1,1,1,1,0,1,0,0,1,0,0],
[0,0,0,1,1,1,1,0,0,0,0,0,0,0,1,1,1,1,1,1,0,1,1,0,1,1,0,1,0,0],
[0,1,0,1,1,0,0,0,1,0,1,1,0,1,0,0,1,1,1,0,1,0,1,0,1,1,0,1,1,0],
[0,1,1,1,0,0,0,1,1,1,1,1,1,0,0,1,0,1,1,1,1,1,0,0,0,1,0,0,1,0],
[1,0,1,1,0,1,1,1,1,0,0,1,1,1,1,1,1,0,1,1,0,0,1,1,0,1,1,0,1,0],
[1,1,1,0,0,1,1,0,0,1,1,0,0,1,1,1,0,0,0,1,0,1,1,1,0,1,1,0,1,0],
[0,1,1,0,1,1,0,1,1,1,1,0,1,0,1,1,1,1,0,1,1,0,0,1,0,1,1,0,1,0],
[0,0,1,0,1,0,1,1,0,0,0,1,0,1,0,1,1,0,0,1,1,1,0,1,0,1,0,0,1,0],
[1,0,1,0,1,0,1,0,1,1,0,0,1,1,0,1,0,0,0,0,1,1,1,0,0,1,0,0,1,0],
[1,1,1,0,1,0,1,0,1,0,1,0,1,1,0,1,1,1,1,0,1,0,0,0,0,1,1,0,1,0],
[0,1,1,0,1,0,1,0,0,0,1,0,1,0,0,1,1,0,0,0,1,1,1,1,0,1,1,0,1,0],
[0,0,1,0,1,1,0,1,1,1,0,0,1,1,0,1,0,0,0,0,1,1,0,1,0,1,0,1,1,0],
[0,1,1,0,0,1,0,0,0,0,0,1,1,1,0,1,1,1,1,0,1,1,1,0,1,1,0,1,1,1],
[0,1,1,1,0,1,1,1,1,1,1,1,0,0,1,1,1,0,0,1,1,1,0,0,1,1,0,1,0,1],
[1,1,1,1,1,0,0,0,1,1,0,0,0,1,1,0,1,1,0,1,1,0,0,1,1,0,0,1,0,1],
[0,1,1,1,1,1,0,0,0,0,0,1,1,1,1,1,0,1,0,1,1,1,0,1,0,0,1,0,0,1],
[0,1,1,1,0,1,1,1,1,1,1,1,0,1,1,1,0,0,1,1,1,0,0,1,1,0,1,0,1,1],
[0,0,1,0,1,1,1,1,0,1,1,1,0,0,1,0,0,1,0,0,0,0,1,1,1,1,0,0,1,0],
[1,1,0,0,0,0,1,0,0,0,1,0,0,0,1,1,1,0,0,1,1,1,1,1,0,0,0,1,1,0],
[0,1,1,1,1,0,0,0,0,0,0,1,1,1,1,0,1,1,0,0,0,0,0,0,0,1,1,1,0,0],
[0,0,0,0,1,1,1,1,1,1,1,1,0,0,0,0,0,1,1,0,0,0,1,1,1,1,0,0,0,0],
[0,0,0,0,0,0,0,0,0,0,0,0,0,0,0,0,0,0,1,1,1,1,1,0,0,0,0,0,0,0],
],
"13112":[
[0,0,0,1,1,0,0,0,0,0,0,0,0,0,0,0,0,0,0,0,0,0,0,0,1,1,0,0,0,0],
[0,0,1,1,0,1,0,0,0,0,0,0,0,0,0,0,0,0,0,0,0,1,1,1,1,0,1,0,0,0],
[0,0,1,0,1,1,1,0,0,0,0,0,0,0,0,0,0,0,0,1,1,1,0,0,1,1,1,0,0,0],
[0,1,1,1,1,0,1,0,0,0,0,0,0,0,0,0,0,0,1,1,0,1,0,1,0,0,1,0,0,0],
[0,1,0,0,0,1,1,0,0,0,0,0,0,0,0,0,1,1,1,0,0,0,1,1,1,0,1,0,0,0],
[0,1,0,1,1,1,1,1,0,0,0,0,0,1,1,1,1,0,1,0,0,0,0,0,1,1,1,1,0,0],
[0,0,1,1,1,0,0,1,0,0,0,0,1,1,0,0,0,0,0,1,1,1,1,1,0,0,0,1,0,0],
[0,1,0,0,0,1,0,1,0,0,0,1,1,0,0,1,1,1,1,0,0,1,1,1,1,1,0,1,0,0],
[0,1,0,1,1,1,0,1,0,0,1,1,0,1,0,0,1,1,1,1,1,0,0,1,1,1,1,1,0,0],
[0,1,0,0,1,1,1,0,0,0,1,0,1,0,1,0,1,0,1,0,1,1,1,0,0,0,0,1,0,0],
[0,0,1,1,1,0,0,1,0,0,1,0,1,1,1,0,1,0,0,0,0,1,1,1,1,1,0,1,1,0],
[0,1,0,0,0,1,0,1,0,0,1,0,1,1,1,0,0,0,0,0,0,1,0,1,0,1,1,0,1,0],
[0,1,0,1,1,1,0,1,0,0,1,0,1,1,1,1,0,1,1,1,0,0,0,0,0,1,1,0,1,0],
[0,1,0,1,1,1,0,1,0,0,1,1,0,1,1,0,0,0,1,1,1,1,0,0,0,0,0,1,1,0],
[1,1,0,1,0,1,0,1,0,0,0,1,0,1,0,1,0,0,1,0,1,1,1,1,1,1,1,1,0,0],
[1,0,0,0,1,1,0,1,0,0,1,1,0,1,0,1,1,1,0,0,0,0,1,1,1,1,0,1,1,0],
[1,0,0,1,1,1,0,1,0,0,1,0,1,0,1,1,1,0,0,1,1,1,0,1,0,1,1,0,1,0],
[1,0,0,0,1,0,1,1,0,1,1,0,1,1,1,1,0,1,1,1,1,1,1,1,1,0,1,0,1,1],
[1,0,1,0,1,0,1,0,0,1,0,0,1,1,1,0,1,1,1,1,0,1,1,1,1,0,1,1,0,1],
[1,0,1,1,1,0,1,0,1,1,0,1,0,1,0,1,1,1,1,1,1,0,1,1,1,1,0,1,0,1],
[1,0,1,1,0,1,1,1,1,0,0,1,1,1,0,1,1,1,0,1,1,0,1,0,1,1,0,1,0,1],
[1,1,0,1,1,1,0,1,0,0,1,1,1,0,0,1,0,1,0,0,1,0,1,0,1,1,0,0,0,1],
[0,1,1,1,1,0,1,1,0,0,0,0,0,0,1,1,1,0,1,1,1,0,0,1,1,1,0,0,1,1],
[0,0,1,1,0,1,1,0,0,0,1,1,1,1,1,1,0,1,1,1,0,1,0,1,1,0,0,1,1,0],
[0,0,0,0,1,1,0,0,0,1,1,1,0,0,0,0,0,0,0,0,1,1,1,1,0,0,1,1,0,0],
[0,0,0,1,1,0,0,1,1,1,0,0,0,1,1,1,1,1,1,0,0,0,0,0,1,1,1,0,0,0],
[0,0,1,1,0,1,1,1,0,0,1,1,1,1,0,0,0,0,1,1,1,1,1,1,1,0,0,0,0,0],
[0,0,1,0,1,1,0,0,1,1,1,0,0,0,0,0,0,0,0,0,0,0,0,0,0,0,0,0,0,0],
[0,0,1,1,0,0,1,1,1,0,0,0,0,0,0,0,0,0,0,0,0,0,0,0,0,0,0,0,0,0],
[0,0,0,1,1,1,1,0,0,0,0,0,0,0,0,0,0,0,0,0,0,0,0,0,0,0,0,0,0,0],
],}