{
"1401":[
[1,1,1,1,1,1,1,1,1,1,1,1,1,1,1,1,1,1,1,0,1,1,1],
[1,1,1,0,1,1,1,1,1,1,0,1,1,1,1,1,1,1,0,1,0,1,1],
[1,1,0,1,0,1,1,1,1,0,1,0,1,1,1,1,1,1,1,0,1,1,1],
[1,1,1,0,1,1,1,0,1,1,0,1,1,1,1,1,1,0,1,1,1,1,1],
[1,0,1,1,1,1,0,1,0,1,1,1,1,0,1,1,0,1,0,1,1,1,1],
[1,1,1,1,1,1,1,0,1,1,1,1,0,1,0,1,1,0,1,1,1,1,1],
[1,1,1,1,1,1,1,1,1,1,1,1,1,0,1,1,1,1,1,1,1,1,1],
[1,0,1,1,1,0,1,1,1,1,1,1,1,1,1,1,1,1,1,1,1,0,1],
[1,0,1,0,1,0,1,1,1,1,0,1,0,1,0,1,1,1,1,1,0,1,0],
[1,1,0,1,1,1,0,1,0,1,1,0,1,1,1,0,1,0,1,1,1,0,1],
[1,1,1,0,1,1,1,0,1,1,1,1,0,1,1,1,0,1,1,1,1,1,1],
[1,1,1,1,0,0,0,1,1,1,1,1,1,0,0,0,1,1,1,1,1,1,1],
[1,1,0,1,0,1,0,1,1,1,1,1,1,0,1,0,1,1,1,1,1,1,1],
[1,0,1,0,0,0,0,1,1,1,1,0,0,0,0,0,1,1,1,1,1,1,1],
[1,1,0,0,0,0,0,1,1,1,1,1,0,0,0,0,1,1,1,1,1,0,1],
[1,1,1,1,1,0,0,0,0,0,0,1,1,1,0,0,0,0,0,0,0,1,1],
[1,1,1,1,1,1,0,0,0,0,0,0,0,1,1,0,0,0,0,0,0,0,1],
[1,1,1,1,1,1,0,0,0,0,0,0,0,1,1,0,0,0,0,0,0,0,1],
[1,1,1,1,1,1,0,1,0,1,0,1,0,1,1,0,1,0,1,0,1,0,1],
[1,1,1,1,1,1,0,1,0,1,0,1,0,1,1,0,1,0,1,0,1,0,1],
[1,1,1,1,1,1,0,1,0,1,0,1,0,1,1,0,1,0,1,0,1,0,1],
[1,1,1,1,1,1,1,1,1,1,1,1,1,1,1,1,1,1,1,1,1,1,1],
[1,1,1,1,1,1,1,1,1,1,1,1,1,1,1,1,1,1,1,1,1,1,1],
],
"1402":[
[0,0,0,0,0,0,0,0,0,0,0,0,0,0,0,0,0,0,0,1,1,1,1,0,0],
[0,0,0,0,0,0,0,0,0,0,0,0,0,0,0,0,0,0,1,1,0,0,1,1,0],
[0,0,0,0,0,0,0,0,0,0,0,0,0,0,0,0,0,1,1,0,0,0,0,1,1],
[0,0,0,0,0,0,0,0,0,0,0,0,0,0,0,0,0,1,0,0,0,0,0,1,1],
[0,0,0,0,0,0,0,0,0,0,0,0,0,0,1,1,1,1,1,0,0,0,0,1,1],
[0,0,0,0,0,0,0,0,0,0,0,1,1,1,1,1,1,1,1,1,0,0,1,1,1],
[0,0,0,0,0,0,0,0,0,0,1,1,1,1,1,1,1,1,1,1,1,1,1,1,0],
[0,0,0,0,0,0,0,0,0,1,1,1,1,1,1,1,1,1,1,1,1,1,0,0,0],
[0,0,0,0,0,0,0,0,1,1,1,1,1,1,1,1,1,1,1,1,1,1,0,0,0],
[0,0,0,0,0,0,0,1,1,1,1,1,1,1,1,1,1,1,1,1,1,1,0,0,0],
[0,0,0,0,0,0,1,1,1,1,1,1,1,1,1,1,1,1,1,1,1,1,0,0,0],
[0,0,0,0,0,1,1,1,1,1,1,1,1,1,1,1,1,1,1,1,1,1,1,0,0],
[0,0,0,0,1,1,1,1,1,1,1,1,1,1,1,1,1,1,1,1,1,1,1,0,0],
[0,0,0,1,1,1,1,1,1,1,1,1,1,1,1,1,1,1,1,1,1,1,1,0,0],
[0,0,1,1,0,0,0,0,0,0,0,0,0,0,0,1,1,1,1,1,1,1,1,0,0],
[0,0,1,0,0,1,1,1,0,1,0,1,1,0,0,0,0,0,1,1,1,1,1,0,0],
[0,1,1,0,0,0,0,0,0,0,0,0,0,0,0,0,0,0,0,1,1,1,1,0,0],
[0,1,0,0,1,1,1,1,1,1,1,1,1,0,0,0,0,0,0,0,0,1,1,1,0],
[0,1,0,0,0,1,1,1,1,1,1,1,1,1,1,1,1,0,0,1,0,0,1,1,0],
[0,1,1,0,0,0,1,1,1,1,1,1,1,1,1,1,1,1,0,0,1,0,0,1,1],
[0,0,1,1,0,0,0,0,0,0,0,0,0,1,1,1,1,1,1,0,1,0,0,1,1],
[0,0,0,1,1,1,0,0,0,0,0,0,0,0,0,0,0,0,0,0,0,0,0,1,1],
[0,0,0,0,0,1,1,1,1,1,1,1,0,0,0,0,0,0,0,0,0,1,1,1,1],
[0,0,0,1,1,1,1,1,1,1,1,1,1,1,1,1,1,1,1,1,1,1,1,1,1],
[1,1,1,1,1,1,1,1,1,1,1,1,1,1,1,1,1,1,1,1,1,1,1,1,0],
],
"1403":[
[1,1,1,1,1,1,1,1,1,1,1,0,0,0,1,1,1,1,1,1,1,1,0,1,1],
[1,1,1,1,1,0,1,1,1,1,0,0,1,0,0,1,1,1,0,1,1,0,1,0,1],
[1,1,1,1,0,1,0,1,1,0,0,1,0,1,0,0,1,0,1,0,1,1,0,1,1],
[1,1,1,1,1,0,1,1,0,0,1,0,1,0,1,0,0,1,0,1,1,1,1,1,1],
[1,0,1,1,1,1,1,1,0,1,1,1,1,1,1,1,0,1,1,1,1,1,1,1,1],
[0,1,0,1,1,1,1,1,0,0,1,0,0,0,1,0,0,1,1,1,1,1,1,1,1],
[1,0,1,1,1,1,1,0,0,1,0,1,0,1,0,1,0,0,1,1,1,1,1,0,1],
[1,1,1,0,1,1,0,0,1,0,1,0,1,0,1,0,1,0,0,1,1,1,0,1,0],
[1,1,0,1,0,1,0,1,1,1,1,1,1,1,1,1,1,1,0,1,1,1,1,0,1],
[1,1,1,0,1,0,0,1,1,1,1,1,1,1,1,1,1,1,0,0,1,1,1,1,1],
[1,1,1,1,1,0,1,1,1,1,1,1,1,1,1,1,1,1,1,0,1,1,1,1,1],
[1,1,0,1,1,0,0,0,1,0,1,0,0,0,0,0,1,0,0,0,1,1,0,1,1],
[1,0,1,0,1,0,0,1,0,0,0,0,0,1,0,0,0,1,0,0,1,0,1,0,1],
[1,1,0,1,1,0,1,0,1,0,1,0,1,0,1,0,1,0,1,0,1,1,0,1,1],
[1,1,1,1,0,0,1,1,0,1,0,1,0,1,0,1,0,1,1,0,0,1,1,1,1],
[0,0,0,1,0,1,1,1,1,1,1,1,1,1,1,1,1,1,1,1,0,1,1,1,1],
[1,1,0,0,0,1,1,1,1,1,1,1,1,1,1,1,1,1,1,1,0,0,1,1,0],
[0,0,1,0,1,1,1,1,1,1,1,1,1,1,1,1,1,1,1,1,1,0,1,0,1],
[1,1,1,1,0,0,1,0,1,0,1,0,1,1,1,0,1,0,1,0,0,0,1,1,0],
[0,0,0,1,1,0,0,0,0,0,1,0,1,1,1,0,0,0,0,0,1,1,1,1,1],
[0,0,0,0,1,0,1,1,1,1,1,0,1,1,1,0,0,0,0,0,1,1,1,1,1],
[0,0,1,1,1,1,1,0,0,0,1,0,1,1,1,1,1,1,1,0,0,0,1,1,1],
[1,1,1,0,0,0,1,0,0,0,1,1,1,1,1,0,0,0,1,1,1,1,0,0,0],
[0,0,0,1,1,1,1,1,0,0,0,0,0,0,0,1,1,1,0,0,0,1,1,1,1],
[0,0,1,1,0,0,0,1,1,0,0,0,0,0,1,1,0,0,1,0,0,0,0,0,0],
],
"1404":[
[1,0,1,1,1,1,1,1,1,0,1,1,1,1,1,1,1,0,1,1,1,1,1,1,1],
[0,1,0,1,1,0,1,1,0,1,0,1,1,0,1,1,0,1,0,1,1,0,1,1,0],
[1,0,1,1,0,1,0,1,1,0,1,1,0,1,0,1,1,0,1,1,0,1,0,1,1],
[1,1,1,1,1,0,1,1,1,1,1,1,1,0,1,1,1,1,1,1,1,0,1,1,1],
[0,0,0,1,1,1,1,1,0,0,0,0,0,0,0,0,0,0,0,0,0,0,0,0,0],
[0,1,1,0,0,0,0,0,1,1,0,0,0,0,0,0,0,0,0,0,0,0,0,0,0],
[1,0,0,0,1,0,0,0,0,1,1,0,0,0,0,0,0,0,0,0,0,0,0,0,0],
[1,0,1,1,1,1,0,1,1,0,1,0,0,0,0,0,0,0,0,0,0,0,0,0,0],
[1,0,0,0,1,1,1,1,0,0,1,0,0,0,0,0,0,0,0,0,0,0,0,0,0],
[0,1,0,0,0,0,0,0,0,1,1,0,0,0,0,1,1,1,1,0,1,1,1,1,0],
[0,1,1,0,0,0,0,0,1,1,0,0,0,0,1,1,0,0,1,1,1,0,0,1,1],
[0,0,1,1,1,1,1,1,1,0,0,0,0,1,1,1,1,0,1,0,1,0,1,1,0],
[0,0,1,1,1,1,1,1,1,0,0,0,1,1,0,0,1,1,1,1,1,1,1,0,0],
[0,0,1,1,1,1,1,1,1,0,0,1,1,0,0,0,0,1,1,1,0,0,0,0,1],
[0,0,1,1,1,1,1,1,1,0,1,1,0,0,0,0,1,1,1,0,0,0,0,1,1],
[0,1,1,1,1,1,1,1,1,1,1,1,1,1,1,1,1,1,1,1,1,1,1,1,0],
[0,1,1,1,1,1,1,1,1,1,1,0,0,0,0,1,1,1,0,0,0,0,0,1,0],
[0,1,1,1,1,1,1,1,1,1,1,1,0,0,0,1,1,1,0,0,0,0,0,1,1],
[0,1,1,1,1,1,1,1,1,1,1,1,1,1,1,1,1,1,1,1,1,1,1,1,0],
[0,0,1,1,1,1,1,1,1,1,1,1,0,0,0,0,1,1,1,0,0,0,1,0,0],
[0,0,0,1,1,1,1,1,1,1,1,0,0,0,0,0,1,1,1,0,0,0,1,0,0],
[0,0,0,0,0,0,1,1,1,1,0,1,0,0,0,0,1,1,1,0,0,0,1,0,1],
[0,0,0,0,0,0,0,0,0,0,0,1,0,0,0,0,1,1,1,0,0,0,1,0,1],
[0,0,0,0,0,0,0,0,0,0,0,1,0,0,0,0,1,1,1,0,0,0,1,1,0],
[0,0,0,0,0,0,0,0,0,0,0,1,1,1,1,1,1,1,1,1,1,1,1,0,0],
],
"1405":[
[1,1,1,1,1,0,1,1,1,1,1,1,1,1,1,1,1,1,1,1,1,1,1,1,1],
[1,1,1,1,0,1,0,1,1,1,1,1,1,1,1,1,1,1,1,1,1,1,1,1,1],
[1,1,1,1,1,0,1,1,1,1,1,1,0,0,0,1,1,1,1,1,0,0,0,0,1],
[1,0,0,0,1,1,1,0,0,0,1,0,0,1,0,0,1,0,0,0,0,1,1,1,0],
[0,0,1,0,0,0,0,0,0,0,0,0,1,0,1,0,0,0,1,1,1,1,0,1,0],
[0,1,0,1,0,1,1,1,0,1,1,1,0,1,0,0,1,1,1,1,1,0,1,1,0],
[0,0,1,0,0,1,0,1,1,1,0,1,0,0,0,0,1,1,1,1,1,0,0,0,0],
[0,0,0,0,0,0,1,0,1,0,1,1,0,0,0,1,0,0,0,0,0,1,0,0,0],
[0,0,1,0,0,0,0,1,1,1,1,0,0,0,0,1,1,1,1,1,1,1,0,0,0],
[0,1,0,1,0,1,1,1,0,0,1,1,0,0,0,0,1,0,1,0,1,1,0,0,0],
[0,0,1,0,1,1,1,0,0,0,0,1,1,0,0,1,1,0,0,1,1,1,0,0,0],
[0,0,0,0,1,1,0,0,0,0,1,0,1,0,0,1,0,1,1,0,1,0,0,0,0],
[0,0,0,1,1,0,0,0,0,0,0,1,1,0,0,1,0,0,0,1,1,0,0,0,0],
[0,0,0,1,0,0,0,0,0,0,1,0,1,0,0,1,0,0,1,0,0,1,0,0,0],
[0,0,0,1,0,0,0,0,0,1,0,1,1,0,1,0,1,1,0,1,1,1,0,0,0],
[0,1,1,1,0,0,0,0,1,0,1,0,1,0,1,1,0,0,1,1,1,1,1,0,0],
[0,1,0,1,1,1,1,1,1,1,0,1,1,0,1,1,1,1,1,1,1,1,1,0,0],
[0,1,0,1,1,1,1,1,1,1,1,1,1,1,1,1,0,1,1,1,1,1,1,0,0],
[0,1,1,0,1,1,1,1,1,1,1,1,0,1,1,1,1,1,1,1,1,1,1,0,0],
[0,1,1,1,1,1,1,1,1,1,1,1,0,1,1,1,0,1,1,1,1,1,1,0,0],
[0,0,1,1,1,1,1,1,1,1,1,1,0,1,1,1,1,1,1,1,1,1,1,0,0],
[0,0,0,1,1,1,1,1,1,1,1,0,0,0,1,1,1,1,1,1,1,1,0,0,0],
[0,0,0,0,0,1,0,0,0,0,1,0,0,0,1,0,1,0,0,1,0,1,0,0,0],
[0,1,0,0,0,1,0,0,0,0,1,0,0,1,1,1,1,0,1,1,1,1,0,0,0],
[1,0,1,1,1,1,1,1,1,1,1,1,1,1,1,1,1,1,1,1,1,1,1,1,1],
],
"1406":[
[1,1,1,1,1,1,1,0,0,0,0,0,0,0,0,0,0,0,1,1,1,1,1,1,1],
[1,1,1,1,1,1,0,0,1,1,1,0,0,0,1,1,1,0,0,1,1,0,1,0,1],
[1,1,1,1,1,0,0,0,1,0,0,1,0,1,0,0,1,0,0,0,1,1,0,1,1],
[1,1,1,1,0,0,0,1,1,0,0,0,1,0,0,0,1,1,0,0,0,1,1,0,1],
[1,1,1,0,0,1,1,0,1,0,0,0,1,0,0,0,1,0,1,1,0,0,1,1,1],
[1,1,0,0,1,1,1,0,1,0,0,1,1,1,0,0,1,0,1,1,1,0,0,1,1],
[1,0,0,1,1,1,1,1,0,1,1,1,1,1,1,1,0,1,1,1,0,1,0,0,1],
[0,0,1,1,0,1,1,1,1,0,0,1,1,1,0,0,1,1,1,0,0,1,0,0,0],
[0,0,1,0,0,0,1,1,1,1,1,0,0,0,1,1,1,1,0,0,1,1,1,0,0],
[0,1,1,1,0,0,0,1,0,0,0,0,0,0,0,0,0,1,0,1,1,1,1,0,0],
[0,1,1,1,1,0,0,1,0,0,1,1,0,1,1,0,0,1,1,1,1,1,1,1,0],
[0,1,1,1,1,1,1,0,0,1,1,1,1,1,1,1,0,0,1,1,1,1,1,1,0],
[0,1,1,1,1,1,1,0,0,1,1,1,1,1,1,1,0,0,1,1,1,1,0,1,0],
[0,1,1,1,1,1,1,0,0,0,1,1,1,1,1,0,0,0,1,1,0,0,0,1,0],
[0,1,1,1,0,0,1,0,0,0,0,1,1,1,0,0,0,0,1,0,0,1,1,1,0],
[0,1,0,0,0,0,1,1,0,0,0,0,1,0,0,0,0,1,1,1,1,1,1,1,0],
[0,0,1,0,1,1,1,1,0,0,0,0,0,0,0,0,0,1,1,1,1,1,1,0,0],
[0,0,1,1,1,1,1,1,1,1,0,0,0,0,0,1,1,0,1,1,1,1,1,0,0],
[0,0,0,1,1,1,1,1,1,1,1,1,1,1,1,1,0,0,0,1,1,1,0,0,0],
[1,0,0,1,1,1,1,1,1,1,0,0,1,1,1,1,1,0,0,0,1,1,0,0,1],
[1,1,0,0,1,1,1,1,1,1,0,0,1,1,1,1,1,1,0,1,1,0,0,1,1],
[1,0,1,0,0,1,1,1,1,0,0,1,1,1,1,1,1,1,1,1,0,0,1,1,1],
[1,1,0,1,0,0,0,1,1,0,0,1,1,1,1,1,1,1,0,0,0,1,1,1,1],
[1,0,1,0,1,0,0,0,0,1,1,1,1,1,1,1,0,0,0,0,1,1,1,1,1],
[1,1,1,1,1,1,0,0,0,0,0,0,0,0,0,0,0,0,0,1,1,1,1,1,1],
],
"1407":[
[0,1,0,1,0,1,0,0,0,0,0,0,0,1,1,0,0,0,0,0,0,0,0,1,1],
[0,0,1,1,1,0,0,0,0,1,0,0,1,0,1,1,0,0,1,0,0,0,1,1,0],
[1,1,1,1,1,1,1,0,1,0,1,0,1,1,1,1,0,0,1,0,0,1,1,0,1],
[0,0,1,1,1,0,0,0,0,1,0,0,0,1,1,0,0,1,1,1,0,1,1,1,1],
[0,1,0,1,0,1,0,0,0,0,0,0,0,0,0,0,0,0,1,0,1,1,1,1,1],
[0,0,0,1,0,0,0,0,0,0,0,0,0,1,0,0,0,0,1,0,1,1,1,1,0],
[0,0,0,0,0,0,0,0,0,0,0,0,0,1,0,0,0,0,1,0,0,1,1,0,1],
[1,0,0,0,1,0,0,0,1,0,0,0,1,1,1,0,0,1,1,1,0,1,1,0,1],
[1,1,0,1,0,1,0,1,1,1,0,0,0,1,0,1,1,1,1,1,1,1,1,0,0],
[1,0,0,0,1,0,0,0,1,0,0,1,1,1,1,1,0,1,1,1,0,1,1,1,0],
[0,1,0,0,0,0,0,1,0,0,1,1,1,1,1,0,1,0,1,0,1,0,1,1,0],
[0,1,1,0,1,0,1,1,0,1,1,1,1,1,1,1,0,0,1,0,0,1,0,1,0],
[1,0,1,0,1,0,1,0,1,1,1,0,1,1,0,1,0,0,1,0,0,1,0,1,0],
[1,1,0,0,1,0,0,1,1,0,0,1,1,1,0,1,0,0,1,0,0,1,0,1,1],
[0,1,1,0,0,0,1,1,0,0,1,1,0,1,0,1,1,0,1,0,1,1,0,1,1],
[0,0,0,0,1,0,0,1,1,1,1,0,0,1,1,0,1,1,1,1,1,0,1,1,1],
[1,1,0,1,0,1,0,1,1,1,0,0,1,1,1,1,1,1,1,1,1,1,1,1,1],
[0,0,0,0,1,0,0,1,1,0,1,1,1,0,1,1,1,1,1,1,1,1,1,1,0],
[0,1,1,0,0,0,1,0,1,1,1,1,1,1,1,0,0,0,0,0,0,0,1,1,0],
[1,1,0,0,1,0,0,0,1,1,1,1,1,1,1,0,1,0,1,0,1,0,0,1,1],
[1,0,1,0,1,0,1,0,1,1,0,1,0,1,1,1,1,1,1,1,1,1,1,1,1],
[0,0,1,0,1,0,1,0,1,1,0,0,1,0,1,1,0,0,0,0,0,0,1,1,1],
[0,1,1,0,0,0,0,0,1,1,1,1,1,1,1,1,1,1,1,1,1,1,1,1,0],
[0,1,0,0,1,0,1,1,1,1,0,0,0,1,1,0,1,1,0,1,1,0,1,1,1],
[1,0,1,0,1,0,1,1,1,0,0,0,1,1,1,0,0,1,0,0,1,0,0,1,1],
],
"1408":[
[1,1,1,1,1,1,1,1,1,1,1,1,1,1,1,1,1,1,1,1,1,1,1,1,1],
[1,1,1,1,1,1,1,1,1,1,1,1,1,1,1,1,1,1,1,1,1,1,1,1,1],
[0,0,1,1,1,1,1,1,1,1,1,1,1,1,1,0,1,0,0,1,1,1,1,1,1],
[0,0,0,1,1,1,1,0,0,0,1,1,1,1,0,0,1,0,0,1,0,0,1,1,1],
[0,0,0,0,1,1,0,0,0,0,1,0,0,1,1,0,0,1,0,1,0,0,1,1,1],
[0,0,0,0,1,1,0,0,0,1,1,1,0,0,1,0,0,1,1,1,0,1,1,0,0],
[0,0,0,0,1,1,0,0,1,1,0,1,0,0,0,1,1,1,1,1,1,1,0,0,0],
[0,0,0,0,1,1,0,0,1,0,0,0,1,0,0,1,0,0,0,0,1,0,0,0,1],
[0,1,1,1,1,1,1,1,1,1,0,0,1,1,0,1,0,0,0,0,1,0,1,1,0],
[0,1,1,1,1,1,1,1,1,1,1,0,0,1,1,1,1,1,1,1,1,1,1,0,0],
[0,0,0,0,1,1,0,0,0,0,1,1,0,1,1,1,1,1,1,1,1,1,1,0,1],
[0,0,1,0,1,1,0,0,0,0,0,1,1,1,0,0,0,0,0,0,0,0,1,1,1],
[0,0,1,1,1,1,1,0,0,0,0,0,1,0,0,0,1,1,1,1,1,0,0,1,0],
[0,0,0,1,0,1,1,0,0,0,1,1,1,0,0,0,1,0,0,0,1,0,0,1,0],
[0,0,0,1,1,0,1,0,0,1,1,0,1,1,0,0,1,0,1,0,1,0,1,1,0],
[0,0,0,1,0,1,1,0,1,1,0,0,0,1,1,1,1,0,1,0,1,1,1,0,0],
[0,0,0,1,1,0,1,1,1,1,0,0,0,1,1,1,1,1,1,1,1,1,1,0,0],
[0,0,0,1,0,1,1,1,1,0,0,0,1,1,0,0,1,1,1,1,0,0,1,1,0],
[0,0,0,1,1,0,1,1,0,0,0,1,1,0,0,1,1,1,1,1,0,0,0,1,1],
[0,0,0,1,0,1,1,0,0,0,0,1,0,0,1,1,0,0,0,1,1,0,0,0,1],
[0,0,1,1,1,0,1,0,0,0,0,1,0,0,1,0,0,0,0,0,1,1,0,0,1],
[0,1,1,1,1,1,1,0,0,0,0,1,1,0,0,0,0,0,0,0,0,1,0,1,1],
[1,1,1,1,0,0,0,0,0,0,0,1,1,1,0,0,0,0,0,0,0,0,1,1,1],
[1,1,1,0,0,0,0,0,0,0,1,1,1,1,1,1,1,1,1,1,1,1,1,1,1],
[1,1,0,0,0,0,0,0,0,1,1,1,1,1,1,1,1,1,1,1,1,1,1,1,1],
],
"1409":[
[1,1,1,1,1,1,1,1,1,1,1,1,1,1,1,1,1,1,0,1,1,1,1,1,1],
[1,1,1,1,1,1,1,1,1,1,1,1,1,1,1,1,1,1,0,1,1,1,1,1,1],
[1,1,1,1,0,0,0,1,1,1,1,1,0,0,1,1,1,1,1,1,1,1,0,0,0],
[0,1,1,1,1,0,0,1,0,1,1,1,0,1,1,1,1,1,1,1,1,1,1,0,0],
[0,0,0,1,1,1,1,1,0,0,0,1,1,1,1,0,0,0,0,0,0,0,1,1,0],
[0,0,0,1,0,0,1,1,1,0,0,1,1,0,0,0,1,1,1,0,0,0,0,1,1],
[0,0,0,1,0,0,0,1,1,1,1,1,0,0,1,1,1,1,1,1,1,0,0,0,1],
[0,0,0,1,0,0,0,1,0,1,1,1,1,1,1,1,0,0,0,1,1,1,1,1,1],
[0,0,0,1,0,0,0,1,0,0,1,1,1,0,1,0,0,0,0,0,1,0,1,1,1],
[0,0,0,1,0,0,0,1,0,0,1,1,1,1,1,0,0,1,0,0,1,1,1,1,1],
[0,0,0,1,0,0,0,1,0,0,1,0,1,0,1,0,0,1,0,0,1,0,1,0,1],
[0,0,0,1,0,0,0,1,0,0,1,1,1,1,1,0,1,1,1,0,1,1,1,1,1],
[1,1,1,1,1,1,1,1,1,1,1,1,1,0,0,0,1,0,1,0,0,0,0,0,1],
[1,1,1,1,1,1,1,1,1,1,1,1,0,1,0,1,1,1,0,1,0,1,0,0,1],
[0,1,0,1,0,1,0,1,0,1,1,1,0,1,0,1,0,1,0,1,0,1,0,0,1],
[1,1,1,1,1,1,1,1,1,1,1,1,0,0,1,1,0,0,0,1,1,0,0,0,1],
[0,0,0,1,0,0,0,1,0,0,1,1,0,0,1,0,0,1,0,0,1,0,1,0,1],
[0,1,1,1,1,1,1,1,1,0,1,1,0,1,1,0,1,0,1,0,1,1,0,0,1],
[1,0,1,0,0,0,1,0,0,1,1,1,0,0,1,1,0,1,0,1,1,0,0,0,1],
[1,1,1,1,1,1,1,1,1,1,1,1,0,0,0,1,0,0,0,1,0,1,0,1,1],
[1,1,1,1,1,1,1,1,1,0,1,1,1,0,0,0,1,1,1,0,1,0,0,1,1],
[0,0,0,1,0,0,0,1,0,0,1,1,1,1,1,0,0,0,0,0,0,0,1,1,1],
[1,0,0,0,0,0,0,0,0,0,1,0,1,1,1,1,1,1,1,1,1,1,1,0,1],
[1,1,0,0,0,0,0,0,0,0,1,1,0,0,0,0,0,0,0,0,0,0,0,1,1],
[1,1,1,0,0,0,0,0,0,0,1,1,1,1,1,1,1,1,1,1,1,1,1,1,1],
],
"1410":[
[0,0,0,0,0,1,0,0,0,0,0,1,1,1,0,0,0,1,1,1,0,0,0,0,0],
[0,0,0,0,0,1,0,0,0,0,0,1,0,1,0,0,0,1,0,1,1,0,0,0,0],
[0,0,0,0,1,1,1,0,0,0,0,1,1,1,0,0,0,1,0,0,1,1,0,0,0],
[0,0,0,1,1,1,1,1,0,0,0,0,0,0,1,1,1,1,0,0,1,1,1,0,0],
[0,0,0,0,1,0,1,0,0,1,1,1,0,0,1,0,0,0,0,1,1,0,1,1,0],
[0,0,0,0,1,1,1,0,0,1,0,1,0,0,1,0,1,0,1,1,0,1,1,1,0],
[0,0,0,0,1,0,1,0,0,1,1,1,1,1,1,0,0,1,1,0,1,1,0,1,0],
[0,0,0,0,1,1,1,0,0,0,0,1,0,0,0,0,1,1,0,1,1,0,1,1,0],
[0,0,0,0,1,0,1,0,0,0,0,1,1,0,0,1,1,0,1,1,0,1,1,0,0],
[0,0,0,0,1,1,1,0,0,0,0,0,1,1,1,1,0,1,1,0,1,1,0,0,0],
[0,0,0,0,1,0,1,0,0,0,0,0,0,1,1,0,1,1,1,1,1,1,1,1,1],
[0,0,0,1,0,1,0,1,0,0,0,0,0,0,1,1,1,1,1,0,1,1,1,0,1],
[0,0,0,1,1,0,1,1,0,0,0,0,0,0,1,1,1,0,0,0,0,0,1,1,0],
[0,0,0,1,0,1,0,1,0,0,0,0,0,1,1,1,1,1,1,1,1,0,0,1,0],
[0,0,1,0,1,1,1,0,1,0,0,0,1,1,0,0,0,0,0,0,0,1,0,1,0],
[0,0,1,1,0,1,0,1,1,0,0,1,1,0,0,0,1,1,1,1,1,1,1,1,0],
[0,0,1,0,1,1,1,0,1,0,0,1,0,0,1,1,0,0,0,0,0,0,1,1,1],
[0,0,1,1,1,1,1,1,1,0,0,1,1,1,0,0,0,1,1,1,1,1,1,1,0],
[0,1,0,1,0,1,0,1,0,1,0,1,1,0,0,1,1,0,0,1,1,0,1,1,0],
[0,1,1,1,1,1,1,1,1,1,0,1,1,1,1,1,0,0,1,0,0,1,1,0,1],
[0,1,0,1,0,1,0,1,0,1,0,1,0,1,1,0,0,1,1,0,1,1,1,0,1],
[0,1,1,0,1,1,1,0,1,1,0,1,1,0,1,0,1,0,0,1,0,0,1,0,1],
[1,0,0,1,1,0,1,1,0,0,1,0,1,0,0,1,1,0,0,1,0,1,0,0,1],
[1,1,1,0,1,0,1,0,1,1,1,0,1,1,0,1,1,0,1,1,0,1,0,0,1],
[1,0,0,1,1,0,1,1,0,0,1,0,0,1,1,0,1,1,1,1,1,1,1,1,1],
],
"1411":[
[1,1,1,1,1,1,1,1,1,1,0,0,1,0,0,1,1,1,1,1,1,1,0,1,1],
[1,1,1,1,1,1,0,1,1,0,1,1,1,1,1,0,1,1,1,0,0,0,1,0,0],
[1,1,1,1,0,0,1,0,0,0,0,1,1,1,0,0,1,1,0,0,1,1,1,1,1],
[1,0,0,0,1,1,1,1,1,0,0,1,0,1,0,0,0,0,1,0,0,1,1,1,0],
[0,1,0,0,0,1,1,1,0,0,0,0,0,0,0,1,0,1,0,1,0,1,0,1,0],
[0,1,1,1,0,1,0,1,0,0,0,0,0,0,1,1,0,0,1,0,1,0,0,0,0],
[1,1,1,0,1,0,0,0,0,1,1,0,0,0,1,0,1,0,0,1,1,0,0,1,0],
[1,1,1,1,0,1,0,0,0,1,0,1,1,0,1,0,1,1,1,1,1,0,0,1,0],
[1,1,1,1,1,1,0,0,0,1,1,0,1,1,1,0,0,1,1,0,1,1,1,0,1],
[1,1,0,1,1,1,1,0,0,0,1,1,0,1,1,1,1,1,1,0,1,0,0,1,0],
[0,1,1,1,1,0,1,0,1,1,1,1,1,0,0,0,0,0,0,1,1,0,0,1,0],
[0,1,1,1,0,1,1,0,1,0,0,1,0,1,1,1,1,1,1,0,1,0,0,0,1],
[1,0,1,0,1,1,0,0,1,1,1,0,1,1,1,1,1,1,1,1,1,0,1,1,1],
[1,0,1,1,1,1,1,1,0,1,1,1,1,1,1,1,0,0,0,1,1,0,0,1,1],
[1,1,0,0,1,1,0,0,1,0,1,1,1,1,0,0,0,0,1,0,1,0,0,1,0],
[1,1,0,1,0,1,1,0,1,0,1,1,1,0,1,0,0,0,1,0,1,0,0,0,0],
[1,1,0,1,0,1,1,0,1,0,1,1,1,0,1,0,0,1,0,1,1,0,0,1,0],
[1,1,0,1,1,0,0,1,1,0,1,1,0,1,0,0,0,0,0,0,1,0,1,0,1],
[1,1,1,0,1,1,1,1,1,1,1,1,1,0,0,1,1,1,0,1,1,0,0,1,0],
[1,1,1,0,0,1,1,1,0,1,1,1,1,1,1,0,0,0,1,1,1,1,0,0,0],
[1,1,0,0,0,1,1,0,0,0,0,0,1,1,1,1,1,1,1,1,1,1,0,1,1],
[0,0,1,0,0,0,1,1,0,0,0,0,0,1,1,0,0,0,1,1,1,1,1,1,1],
[1,1,1,1,1,0,0,1,1,1,1,0,0,0,1,1,1,1,1,0,1,1,1,1,1],
[0,1,1,1,0,1,1,0,0,1,1,1,0,0,0,0,0,1,1,0,1,0,1,1,1],
[0,1,0,1,0,1,1,1,1,0,1,1,1,0,0,0,1,1,0,0,1,0,1,1,1],
],
"1412":[
[0,0,0,0,0,0,1,1,0,0,1,1,1,1,1,1,1,1,1,1,1,1,1,1,1],
[0,1,1,0,1,1,1,0,1,0,0,1,1,1,0,0,0,0,0,1,1,1,1,1,1],
[1,1,1,1,1,0,1,0,1,1,0,1,1,1,0,1,1,1,0,0,1,1,1,1,1],
[1,0,1,1,1,0,1,0,1,1,0,0,1,0,0,1,0,1,1,0,0,1,1,1,1],
[1,1,0,0,1,1,0,0,0,1,0,0,0,0,0,1,1,0,1,1,0,0,1,1,1],
[0,1,1,1,0,1,1,0,1,1,0,0,0,0,0,1,1,0,0,1,1,0,0,1,1],
[0,0,1,1,1,0,1,1,0,1,1,1,1,1,1,1,0,0,1,0,1,1,0,1,1],
[0,1,1,0,0,0,0,1,1,1,1,1,1,0,0,0,0,1,1,1,0,1,0,1,1],
[1,1,0,1,1,1,1,0,1,1,0,0,1,1,1,1,0,1,1,1,1,1,0,1,1],
[1,1,1,0,0,0,1,1,1,0,0,0,1,1,0,1,0,1,1,0,1,1,0,1,1],
[0,0,0,1,1,1,1,1,1,1,1,1,1,1,1,1,0,1,0,0,0,0,0,1,1],
[0,0,1,1,1,1,1,1,0,0,1,1,0,0,1,1,0,1,0,0,0,0,1,1,1],
[0,0,1,0,1,1,1,1,1,0,0,1,0,0,1,1,1,1,1,0,0,1,1,1,1],
[1,1,1,0,1,0,0,1,1,1,1,1,1,1,1,0,0,1,1,0,1,1,1,1,1],
[1,0,0,1,1,0,1,1,0,1,1,0,0,1,1,1,0,1,1,0,1,1,1,1,1],
[1,1,0,0,1,1,1,0,0,0,1,1,0,0,1,1,1,1,0,0,0,1,1,1,1],
[0,1,0,0,1,1,1,1,0,0,1,1,1,1,1,0,1,0,0,0,0,0,1,1,1],
[0,1,1,0,1,1,0,1,1,1,0,0,1,1,0,0,1,1,1,1,1,0,0,0,1],
[0,1,1,0,1,0,0,0,1,1,0,0,1,1,0,1,1,1,1,0,1,1,1,0,0],
[1,1,0,1,1,0,0,1,1,1,1,1,1,1,1,1,1,1,0,0,0,0,1,1,0],
[1,0,1,1,1,1,1,1,0,0,1,1,1,0,0,0,1,0,0,1,1,1,1,1,0],
[1,1,1,0,1,1,1,1,0,0,1,1,0,0,1,1,0,1,0,1,1,1,0,0,0],
[0,0,0,0,1,1,0,1,1,1,1,0,0,1,1,1,0,1,1,0,1,1,1,0,0],
[0,0,0,0,1,0,0,1,1,0,1,0,1,1,0,1,1,0,1,0,1,1,1,0,0],
[0,0,0,0,1,1,1,1,0,0,1,1,1,0,0,0,1,1,0,1,0,1,1,0,0],
],}