{
"14001":[
[1,1,1,0,1,1,1,1,1,0,1,1,1,1,1,0,0,1,1,1,1,0,1,1,1],
[1,1,0,0,1,0,1,1,1,0,0,1,1,1,1,0,1,1,0,0,1,0,1,1,1],
[1,1,0,1,1,1,1,1,1,1,0,1,0,0,0,0,1,0,0,1,0,0,0,0,0],
[1,1,0,1,0,0,0,0,0,1,0,0,0,1,1,1,1,0,1,1,1,1,1,1,1],
[1,1,0,1,1,1,1,1,1,1,1,1,1,1,0,0,0,0,1,1,1,0,0,0,1],
[1,1,0,0,1,1,1,0,1,1,0,0,1,0,0,1,0,0,0,0,1,1,0,1,0],
[1,1,0,0,1,1,1,0,1,0,0,1,1,1,1,1,0,0,1,0,0,1,0,0,1],
[0,0,0,1,1,1,1,0,1,1,0,1,1,1,1,1,0,1,1,1,1,1,1,0,1],
[0,1,1,1,0,1,1,1,0,1,1,1,1,1,0,1,1,1,0,1,1,1,1,0,0],
[1,1,0,0,1,1,1,1,1,0,0,1,1,1,1,0,0,0,0,0,0,1,1,1,0],
[1,0,0,1,1,0,0,0,0,1,0,0,1,1,0,1,0,0,1,1,0,0,1,1,1],
[1,0,1,1,1,1,1,0,0,1,1,0,1,0,1,0,0,0,0,1,0,0,1,0,1],
[1,0,1,1,0,0,0,0,0,1,1,0,1,1,0,0,1,0,1,1,1,0,0,1,1],
[1,0,1,1,0,0,0,0,0,1,1,0,1,1,0,1,0,1,0,1,1,0,1,0,1],
[1,0,1,1,1,1,0,1,0,1,1,0,1,0,1,0,1,0,1,0,1,0,0,1,1],
[1,0,1,0,1,1,0,0,1,0,1,0,1,1,0,0,0,0,1,1,1,0,1,0,1],
[1,0,1,0,1,1,1,0,1,0,1,0,1,1,1,0,0,1,1,1,0,0,0,1,1],
[1,0,1,0,1,1,1,1,0,0,1,0,1,1,1,0,0,1,1,1,0,0,1,1,0],
[1,0,1,0,0,1,1,1,0,1,1,0,1,1,0,1,0,0,1,0,0,0,1,1,0],
[1,0,1,1,1,0,0,0,0,1,1,0,1,0,1,0,1,0,0,0,0,1,0,0,1],
[1,0,1,1,0,1,1,1,1,1,1,0,1,0,0,0,0,0,0,0,0,1,1,1,1],
[1,0,0,0,1,1,1,1,1,0,0,0,1,1,1,1,1,1,1,1,1,1,1,1,1],
[1,1,1,0,0,0,0,0,0,0,1,1,1,1,1,1,1,1,1,1,1,1,1,0,1],
[1,1,1,1,1,1,1,1,1,1,1,1,1,0,1,1,1,0,1,0,0,1,0,1,0],
[0,0,1,1,1,1,1,1,1,1,1,0,0,1,0,0,0,1,0,0,0,0,1,0,0],
],
"14002":[
[1,1,0,1,0,1,1,1,1,1,1,1,1,1,1,1,1,1,0,0,1,1,1,0,1],
[0,0,1,0,0,1,0,0,0,0,0,0,0,0,1,1,0,1,0,1,1,0,0,1,1],
[1,1,0,1,0,1,1,1,1,1,1,1,1,1,1,1,1,1,0,1,0,0,1,1,1],
[1,0,1,0,0,0,1,0,0,0,0,0,1,1,0,0,1,0,0,1,0,1,1,0,1],
[1,1,0,1,0,0,1,1,1,1,1,1,1,1,1,1,1,0,0,1,0,0,0,1,1],
[0,0,1,0,0,1,1,0,0,0,0,0,1,1,1,0,1,1,0,0,1,1,1,1,0],
[1,1,1,0,1,1,0,0,0,0,0,1,0,0,1,1,0,1,1,0,0,0,0,0,0],
[1,0,0,0,1,0,0,1,1,1,1,1,1,1,1,1,0,0,1,0,0,1,1,1,1],
[1,0,0,1,1,0,0,0,0,0,0,0,0,1,1,1,1,0,1,1,1,1,0,0,1],
[0,1,0,1,0,0,1,0,0,0,0,1,1,0,1,1,1,0,0,1,0,0,1,0,1],
[1,0,0,1,0,0,0,1,1,1,1,1,1,1,1,1,1,1,1,1,0,1,0,0,1],
[1,1,0,1,0,0,0,1,1,1,1,1,1,0,0,0,0,0,1,1,1,1,0,1,1],
[1,0,0,1,0,1,1,0,0,1,1,0,0,0,1,1,1,1,0,0,1,0,1,1,0],
[0,1,0,1,0,0,0,0,1,1,1,0,0,0,0,0,0,0,1,1,0,1,1,1,0],
[1,0,0,1,0,0,1,0,0,0,1,1,0,0,0,1,1,1,0,1,0,1,0,0,0],
[1,0,0,1,0,1,1,0,0,1,1,1,1,1,0,0,1,1,1,1,0,1,0,0,0],
[0,1,0,1,0,1,0,1,0,1,1,1,1,1,1,1,1,1,1,1,0,1,0,0,0],
[1,0,0,1,0,1,1,1,1,1,1,1,1,1,0,0,0,0,1,0,1,1,0,0,0],
[0,1,0,1,0,0,1,1,1,1,1,1,0,0,0,0,1,0,1,1,1,1,1,1,0],
[0,0,0,1,0,0,0,0,0,0,1,0,0,0,1,0,1,0,1,1,0,0,0,1,0],
[0,1,1,1,1,0,0,0,0,1,1,0,1,1,0,1,1,0,1,0,1,0,0,1,1],
[1,1,1,1,1,1,1,1,1,1,0,1,1,1,1,0,0,1,1,0,1,0,1,0,1],
[0,0,1,1,1,1,1,1,1,1,0,0,0,0,0,1,1,1,1,0,1,1,0,0,1],
[0,0,0,0,0,0,0,1,1,1,1,1,1,1,1,1,1,1,1,0,1,1,0,0,1],
[0,0,0,0,0,0,0,0,0,0,0,1,1,1,1,0,0,1,1,1,0,1,1,0,1],
],
"14003":[
[0,0,0,0,0,1,1,1,0,0,0,0,0,0,0,0,1,1,1,1,1,1,0,0,0],
[0,0,1,1,1,1,1,1,1,1,0,0,0,0,0,1,1,0,0,0,0,0,1,1,0],
[0,0,1,0,0,1,1,1,0,1,0,0,0,0,0,0,1,1,0,1,1,1,0,1,1],
[0,0,1,1,0,1,1,1,0,1,1,1,1,1,1,0,0,1,0,1,0,1,0,0,1],
[0,0,0,0,1,0,0,0,0,1,1,0,0,0,1,1,0,1,0,0,0,1,1,0,1],
[0,0,0,0,1,0,0,1,0,1,0,1,1,0,0,1,0,1,1,0,1,0,1,1,0],
[0,0,0,1,1,0,1,1,0,1,0,1,1,1,0,1,0,0,1,0,1,0,1,1,1],
[0,1,1,1,0,0,1,1,0,0,1,1,1,1,0,1,0,0,1,0,0,0,1,0,1],
[1,1,0,0,0,1,0,0,1,0,0,1,0,0,1,1,0,0,1,1,0,0,1,0,1],
[1,0,0,1,0,1,1,1,0,1,0,1,1,1,1,0,0,0,0,1,1,1,0,0,0],
[1,0,0,1,1,1,1,1,1,1,1,0,1,1,1,1,1,0,0,0,0,1,1,1,1],
[1,1,1,1,0,0,0,1,1,1,1,0,1,0,0,0,1,1,1,0,1,1,1,0,0],
[1,1,0,0,0,1,1,0,1,1,1,1,1,0,1,1,0,0,1,0,1,0,0,0,1],
[1,1,0,1,1,0,1,0,1,1,1,1,0,1,1,1,1,0,1,0,1,0,1,1,0],
[1,1,0,0,0,0,1,1,0,1,1,1,0,1,1,0,1,0,1,1,1,0,1,0,0],
[1,1,0,0,0,0,0,1,0,1,1,1,0,1,0,0,1,0,0,1,0,0,1,0,0],
[1,0,0,0,0,0,0,0,0,1,1,0,0,0,0,1,0,1,0,1,0,0,0,0,0],
[1,0,0,0,1,1,1,0,0,0,1,1,0,1,0,0,1,1,0,1,1,0,0,1,1],
[1,0,0,1,0,0,1,1,0,0,0,1,1,0,1,0,1,1,0,0,1,0,1,0,0],
[1,0,0,1,1,1,0,1,0,0,0,1,1,1,1,1,0,1,1,0,1,0,1,1,0],
[1,0,0,1,1,1,1,1,0,0,0,1,1,1,1,1,1,1,1,0,1,0,1,1,1],
[1,1,0,0,1,1,1,0,0,0,0,1,1,1,1,1,1,1,0,0,1,0,0,1,1],
[0,1,0,0,0,0,0,0,0,0,1,0,0,0,1,1,0,0,0,1,0,0,0,0,0],
[1,1,1,0,0,0,0,0,1,1,1,1,1,0,0,0,0,1,1,1,1,1,0,0,0],
[1,1,1,1,1,1,1,1,1,1,1,1,1,1,1,1,1,1,1,1,1,1,1,1,1],
],
"14004":[
[0,0,0,0,0,1,1,1,1,1,0,0,0,1,1,1,0,0,0,0,1,1,1,1,1,1,1,0,0,0],
[0,0,0,0,0,1,1,1,0,1,0,0,0,1,0,1,1,0,1,1,1,0,1,0,1,0,1,1,0,0],
[0,0,0,0,1,1,1,1,1,1,1,0,0,1,0,0,1,0,1,0,0,1,0,1,1,0,0,1,1,0],
[0,0,1,0,1,0,0,0,0,0,1,0,1,1,0,0,1,1,1,0,1,1,0,1,0,1,1,0,1,0],
[0,0,1,0,1,1,1,1,1,1,1,0,1,0,0,1,0,1,1,1,1,0,0,1,0,1,0,0,1,1],
[1,1,0,1,0,1,1,1,0,1,0,0,1,0,0,1,0,1,0,0,1,1,1,1,1,1,1,0,1,1],
[0,0,1,0,0,1,1,0,0,1,0,0,1,0,0,1,0,1,1,0,1,0,0,1,1,0,1,1,0,1],
[0,0,1,0,0,1,1,0,0,1,0,0,1,1,0,0,1,1,0,1,1,1,0,1,0,0,1,0,0,1],
[0,0,0,0,1,1,1,1,0,1,1,0,0,1,0,1,1,1,0,0,1,1,1,1,1,1,1,0,1,1],
[0,1,1,1,1,0,0,0,0,0,1,1,1,1,0,1,1,1,1,0,1,0,0,1,0,1,1,1,0,0],
[0,1,0,0,0,0,1,1,1,1,0,0,0,1,0,1,1,0,0,1,1,0,0,1,0,0,1,1,0,0],
[1,1,0,0,1,0,0,0,1,1,1,1,0,1,1,0,1,0,0,1,1,1,1,1,1,0,0,1,0,1],
[1,0,0,1,0,0,0,1,0,0,1,0,1,0,1,0,1,1,0,1,0,0,1,1,1,1,1,1,1,0],
[1,0,0,1,1,1,1,1,1,0,0,1,1,0,1,1,1,0,1,1,0,0,0,1,0,0,0,1,0,0],
[1,0,1,1,0,1,1,1,0,0,1,0,1,0,1,1,1,1,1,1,1,0,1,1,0,0,0,1,0,1],
[1,0,1,1,1,0,0,0,1,1,1,1,1,1,1,1,1,1,1,1,1,1,1,1,1,0,1,1,1,0],
[1,0,1,1,0,0,0,0,1,1,1,1,0,0,0,0,0,0,0,0,0,0,0,1,1,1,1,1,0,0],
[1,0,1,1,1,1,1,1,1,0,0,0,0,1,0,0,0,0,0,1,1,0,0,0,0,0,1,1,1,1],
[1,0,1,1,1,1,1,0,0,0,1,0,1,0,0,1,1,1,1,1,1,1,1,1,1,1,0,0,1,1],
[1,0,1,1,1,0,0,1,1,0,1,1,1,0,1,1,0,0,1,1,1,0,1,1,0,1,0,0,0,1],
[1,0,1,1,0,1,1,1,1,1,1,1,1,1,0,1,1,1,0,1,0,0,1,0,0,1,0,1,0,0],
[1,0,1,1,0,0,0,0,1,1,1,0,0,0,0,0,0,1,1,1,1,1,0,1,1,0,1,1,1,0],
[1,0,1,0,1,1,1,1,0,0,0,1,1,1,0,0,0,0,1,1,0,1,0,0,1,0,1,0,0,1],
[1,0,1,0,0,0,0,0,1,1,1,1,1,1,1,1,1,1,1,1,0,1,0,1,1,1,1,0,1,0],
[1,0,1,0,1,0,1,0,0,0,0,1,1,1,0,0,1,0,1,0,0,1,1,1,1,0,1,1,0,1],
[1,0,1,0,0,1,0,1,1,0,0,0,1,1,1,1,0,0,0,1,1,0,1,0,0,1,0,1,1,1],
[1,1,1,1,0,0,1,1,1,1,1,0,0,0,1,1,1,1,1,0,0,1,1,1,1,0,1,0,1,1],
[1,1,1,1,1,1,0,0,0,0,1,1,1,1,0,0,1,1,1,1,1,0,0,1,0,1,1,0,0,0],
[1,1,1,1,1,1,1,1,1,1,0,0,0,0,0,0,0,0,0,0,0,1,0,0,0,0,0,0,0,1],
[0,0,1,1,1,1,1,1,1,1,1,1,1,1,1,1,1,1,1,1,1,1,1,1,1,1,1,1,1,1],
],
"14005":[
[1,1,0,0,1,1,1,1,1,1,0,0,0,0,0,0,0,0,0,0,1,0,0,1,1,1,1,0,0,0],
[0,1,0,0,0,1,1,1,0,1,0,0,0,0,0,0,0,0,0,0,1,0,0,1,0,1,1,0,0,0],
[0,1,1,0,1,1,0,0,0,1,0,1,1,1,0,0,0,1,1,1,0,1,0,1,0,1,1,0,0,0],
[0,0,1,0,1,0,0,1,0,1,1,1,0,1,0,0,0,0,0,0,1,0,1,1,1,1,1,1,0,0],
[1,0,1,1,1,0,1,1,0,1,0,0,0,1,0,1,1,1,1,0,1,0,1,0,0,0,0,1,0,0],
[1,0,1,1,0,1,1,0,1,1,0,1,0,1,1,1,0,0,1,0,0,0,1,1,1,1,1,1,0,0],
[1,0,0,1,0,1,0,0,1,0,1,0,0,1,0,0,0,0,1,0,0,0,0,1,1,1,1,0,0,0],
[0,1,1,1,1,0,0,1,1,0,1,0,1,1,0,1,0,1,1,0,0,0,0,1,0,1,1,0,0,0],
[1,1,1,1,1,1,1,1,0,1,0,0,1,0,1,1,0,1,0,1,0,0,0,1,0,1,1,0,0,0],
[1,0,0,0,0,0,1,1,1,1,1,1,1,1,1,1,1,0,1,0,1,0,0,1,0,0,1,0,0,0],
[0,1,1,0,1,0,0,0,1,1,1,0,0,0,0,1,1,1,0,1,0,0,1,1,0,0,1,1,0,0],
[1,1,1,1,0,1,0,1,0,1,0,0,1,1,0,0,0,1,0,0,0,1,1,0,0,0,0,1,1,0],
[0,1,0,0,1,0,1,0,0,1,1,1,0,0,0,0,1,1,0,0,0,1,0,0,1,1,0,0,1,0],
[1,0,1,0,0,1,0,1,1,0,1,1,0,1,1,1,1,1,1,0,1,1,0,1,0,0,1,0,1,1],
[0,1,0,1,1,0,1,0,1,0,1,1,1,1,0,0,0,0,1,0,1,0,1,0,1,1,1,1,0,1],
[1,0,0,1,1,1,1,1,1,0,1,0,0,1,1,1,0,0,1,0,1,0,1,0,0,0,0,1,0,1],
[0,1,1,0,1,0,0,1,1,0,1,1,1,0,0,1,0,1,1,0,1,0,1,0,0,0,0,1,0,1],
[1,0,0,1,0,1,1,1,0,0,1,1,0,1,0,1,1,1,0,0,1,0,1,0,0,0,1,1,0,1],
[1,1,1,0,1,0,1,1,0,1,1,1,0,0,0,0,1,0,0,0,1,0,1,0,0,1,1,1,0,1],
[1,1,1,1,1,1,1,0,0,1,0,1,1,0,0,0,1,0,0,0,1,0,1,1,0,0,1,1,0,1],
[0,1,1,1,1,1,0,0,1,1,1,0,1,1,1,0,1,0,0,0,1,0,1,1,0,0,1,1,0,1],
[1,0,0,0,0,0,1,1,1,0,1,0,0,1,1,1,1,1,0,0,1,0,1,1,1,0,1,1,0,1],
[1,1,1,1,1,1,1,1,1,0,1,1,0,1,1,0,0,1,0,0,1,0,1,1,0,1,1,1,0,1],
[0,1,1,1,0,1,0,0,1,0,0,1,0,1,0,1,0,1,1,0,1,0,1,1,1,1,1,1,0,1],
[0,1,1,1,0,1,0,1,1,1,0,1,0,1,1,0,0,0,1,0,1,0,1,1,1,1,1,1,0,1],
[1,0,1,0,1,0,0,1,0,1,1,0,0,1,1,1,1,1,1,0,1,0,0,1,1,1,1,0,0,1],
[1,0,1,0,1,0,0,1,0,0,1,0,1,1,0,0,0,0,0,0,1,0,0,0,0,0,0,1,0,1],
[0,1,1,0,0,0,1,1,0,0,1,1,1,0,0,0,0,0,0,1,1,0,0,0,0,1,1,0,0,1],
[0,1,0,0,1,1,1,1,1,0,1,0,0,0,0,0,0,1,1,1,1,1,0,0,0,0,0,0,1,1],
[1,1,1,1,1,0,0,0,1,1,0,0,0,0,0,0,0,0,1,1,1,1,1,1,1,1,1,1,1,1],
],
"14006":[
[0,1,1,1,1,1,0,0,1,1,1,1,0,1,1,1,1,1,1,1,1,1,1,1,1,1,1,1,1,0],
[1,1,0,0,0,1,1,0,1,1,1,1,0,1,0,0,0,0,0,0,0,1,1,1,1,1,1,1,1,1],
[1,0,1,0,1,0,1,0,0,0,0,1,0,1,0,0,0,0,0,0,0,0,0,0,0,0,0,1,1,1],
[1,0,0,1,1,0,1,1,1,1,0,0,0,1,1,1,1,0,0,1,0,1,1,1,1,0,1,1,1,0],
[1,0,1,1,1,0,1,0,0,1,1,0,0,1,0,0,0,0,0,0,0,0,0,0,0,0,1,1,1,1],
[1,1,0,0,0,1,1,0,1,0,1,0,0,1,1,1,1,1,1,1,1,1,1,1,1,1,1,1,1,0],
[0,1,1,1,1,0,0,1,1,0,1,0,0,0,1,1,0,0,0,1,0,1,1,1,1,0,0,1,0,0],
[0,0,0,0,1,0,1,1,1,0,1,0,0,1,1,0,0,0,0,0,1,1,1,0,1,1,1,0,1,1],
[1,1,1,0,1,1,0,0,0,1,0,0,0,1,0,0,1,1,0,0,0,0,1,0,1,1,1,0,0,1],
[1,1,1,0,0,1,1,1,1,1,1,1,1,1,1,1,1,1,1,1,0,0,0,0,1,0,1,1,0,1],
[1,1,1,0,0,1,1,1,0,0,0,0,0,0,0,0,0,0,1,1,1,0,0,0,0,1,1,1,0,1],
[1,1,1,0,1,1,0,0,0,1,1,1,1,0,1,0,0,1,0,0,1,1,1,0,0,0,0,1,0,1],
[1,1,0,0,1,0,0,1,1,1,1,0,0,1,1,1,1,0,1,0,0,1,1,1,0,1,0,1,0,1],
[1,1,0,1,1,0,0,0,1,0,0,1,1,1,1,1,1,1,0,1,0,1,1,1,0,1,0,1,0,1],
[1,1,0,1,0,0,1,0,0,0,1,1,0,0,0,0,1,1,1,0,0,0,1,0,1,1,1,1,0,1],
[1,0,0,1,0,1,0,1,0,1,1,0,1,1,1,1,0,0,1,1,1,1,1,1,1,1,1,1,0,1],
[1,0,1,1,0,1,0,1,0,1,0,1,1,1,1,1,1,1,0,0,0,0,1,1,1,1,1,1,0,1],
[1,0,1,0,0,1,0,0,1,1,0,1,1,0,0,1,0,1,1,1,1,1,0,0,0,1,1,1,0,1],
[1,0,1,0,1,1,0,1,1,1,0,0,1,0,0,0,1,0,1,1,0,1,1,1,1,0,0,1,1,1],
[1,0,1,0,1,1,0,1,1,0,0,0,1,1,0,0,0,0,0,0,1,0,1,1,1,1,1,0,1,1],
[1,0,1,0,1,1,0,1,1,0,1,1,0,1,1,1,0,0,0,0,0,0,0,0,1,0,1,1,0,1],
[1,0,1,0,1,0,0,1,1,0,1,1,0,0,1,1,1,1,1,0,0,0,0,0,0,1,0,1,0,1],
[1,0,1,0,1,1,0,1,1,0,0,1,1,1,0,0,0,1,1,1,1,1,0,0,0,0,1,1,0,1],
[1,0,1,1,0,1,0,0,1,1,0,1,0,1,1,1,0,0,0,0,1,1,1,1,1,1,0,0,0,1],
[0,0,0,1,0,1,1,0,1,1,0,1,0,0,0,0,0,1,0,0,0,0,0,0,0,0,1,0,1,1],
[0,0,1,1,0,1,1,0,1,1,0,0,1,0,1,1,0,0,1,1,1,0,1,1,1,1,0,0,1,0],
[1,1,1,1,1,0,0,1,0,1,1,0,0,0,0,1,1,0,0,1,1,1,1,0,1,1,0,1,1,0],
[1,1,1,1,1,1,1,0,0,0,1,1,1,0,0,0,1,1,1,1,1,1,1,1,0,0,0,1,1,1],
[0,1,1,1,1,1,1,1,1,1,1,1,1,1,1,1,0,0,0,0,0,0,0,0,0,1,1,1,1,1],
[0,0,0,0,0,0,1,1,1,1,1,1,1,1,1,1,1,1,1,1,1,1,1,1,1,1,1,1,1,0],
],
"14007":[
[1,1,1,1,0,0,0,1,1,1,1,1,1,1,0,0,1,1,1,0,1,1,1,1,1],
[1,1,1,1,0,1,1,1,0,0,0,0,0,1,1,1,1,0,1,0,1,1,1,1,1],
[1,1,1,1,0,1,0,0,1,1,1,1,0,0,1,0,0,1,0,0,0,1,1,1,1],
[1,1,1,1,0,0,1,0,0,0,0,1,1,1,0,0,1,1,1,1,0,0,0,1,1],
[1,1,1,1,0,0,1,1,1,0,0,0,0,1,0,1,1,0,0,1,1,1,0,0,1],
[1,1,1,0,0,1,1,0,1,1,1,1,1,1,0,1,0,1,0,0,0,1,1,0,0],
[1,1,1,0,1,1,0,0,0,0,1,1,1,1,1,1,1,1,0,0,1,0,1,1,0],
[1,1,0,0,1,0,0,1,0,0,0,0,1,1,1,1,1,0,0,0,1,0,0,1,0],
[1,1,0,1,1,0,1,0,0,0,1,0,0,0,0,0,0,0,0,1,0,1,0,1,1],
[0,0,0,1,0,1,1,0,1,1,0,1,0,0,0,0,1,1,1,1,0,1,0,0,1],
[1,1,1,1,1,1,1,1,1,0,1,0,1,0,0,0,0,0,0,0,1,0,1,0,1],
[1,0,0,0,1,1,1,1,1,1,0,1,1,0,0,0,0,0,0,0,0,1,1,0,1],
[1,0,1,0,0,0,0,0,1,1,1,1,1,1,0,0,0,0,0,1,0,1,1,0,1],
[1,0,1,0,0,0,1,0,0,0,1,1,1,1,0,0,0,1,1,0,1,1,0,0,1],
[1,0,1,0,0,0,1,1,1,0,0,0,0,1,1,1,0,0,0,1,1,0,1,0,1],
[1,0,1,0,0,0,0,1,1,1,1,0,0,0,0,1,1,1,0,1,1,1,1,0,1],
[1,0,1,1,0,0,0,0,0,0,1,1,0,0,1,0,1,0,0,1,1,1,1,0,1],
[1,0,1,1,0,0,0,1,1,1,0,1,0,0,1,0,1,0,1,1,1,1,0,0,1],
[1,1,0,1,0,0,0,0,0,1,1,0,0,1,1,0,1,1,0,1,1,0,1,0,1],
[0,1,0,1,1,0,0,0,0,0,0,0,1,1,0,1,1,1,1,0,0,1,0,1,1],
[0,1,1,0,1,1,1,0,0,0,1,1,1,1,0,1,1,1,1,1,1,0,0,1,0],
[0,0,1,0,0,1,1,1,1,1,1,1,1,0,1,1,1,0,1,0,0,0,0,1,0],
[1,1,1,1,0,0,0,0,1,1,1,1,0,0,1,1,1,1,0,0,0,1,1,0,0],
[1,1,1,1,1,1,1,0,0,0,0,0,1,1,0,0,0,0,0,1,1,1,1,1,1],
[0,1,1,1,1,1,1,1,1,1,1,1,1,1,1,1,1,1,1,1,1,1,1,1,1],
],
"14008":[
[1,1,1,1,0,0,1,1,1,1,1,1,1,1,1,1,1,0,0,1,1,1,1,1,1],
[1,0,0,0,1,0,0,0,0,1,1,1,1,1,1,1,1,0,1,1,0,0,1,1,1],
[0,1,0,1,1,1,1,1,1,0,0,0,1,1,1,0,0,0,1,0,0,1,0,0,1],
[0,1,1,0,0,0,0,0,1,1,1,0,1,1,0,0,1,1,0,0,1,1,0,1,1],
[0,1,0,0,1,1,1,1,0,0,1,0,0,1,0,1,0,0,1,1,1,0,0,1,0],
[1,1,0,0,0,0,1,1,1,0,1,1,0,1,0,1,1,1,0,0,0,0,1,1,0],
[1,0,0,0,0,0,1,1,1,1,0,1,0,1,0,0,0,1,1,1,1,1,1,0,0],
[1,0,1,0,0,0,0,0,1,1,0,1,0,0,1,1,1,0,0,0,0,0,0,0,0],
[1,0,1,0,0,0,0,1,0,1,0,1,1,0,0,0,1,1,0,0,0,0,0,0,0],
[1,0,1,1,0,0,0,0,0,0,0,0,1,1,1,0,0,0,0,1,1,1,1,1,1],
[1,0,0,1,1,0,0,0,1,0,1,0,0,0,1,1,1,1,1,1,0,0,0,0,1],
[1,1,0,1,1,1,1,1,0,0,0,1,1,0,0,1,1,0,0,0,0,0,0,0,0],
[0,1,0,0,1,1,1,0,0,1,0,1,1,1,1,1,0,0,0,0,1,1,1,1,0],
[0,1,1,0,0,1,0,0,0,1,1,1,1,0,0,0,0,1,1,1,1,1,1,1,1],
[0,1,1,0,1,1,0,0,0,1,1,0,0,0,1,1,1,1,1,0,1,0,0,0,1],
[0,1,0,0,1,0,1,0,0,1,1,0,1,1,1,1,1,0,0,0,0,0,0,0,0],
[1,1,0,1,1,1,0,0,0,1,0,1,1,0,0,0,0,0,0,1,1,0,0,0,0],
[1,0,0,1,1,0,0,0,1,1,0,1,0,0,0,0,0,0,1,1,1,1,0,1,1],
[1,0,1,1,1,0,1,1,1,0,1,1,0,0,0,0,0,0,0,0,0,0,0,0,0],
[1,0,1,1,1,1,1,0,0,1,1,0,0,0,1,1,1,1,0,1,1,1,1,0,0],
[1,0,1,1,1,1,1,0,1,1,0,1,1,1,0,0,0,0,0,1,1,1,0,0,0],
[1,0,0,1,1,1,0,0,0,0,0,0,0,0,0,0,0,0,0,0,0,0,0,0,1],
[1,1,0,1,0,0,0,0,0,1,1,1,0,0,0,0,0,0,0,1,1,1,1,1,1],
[0,1,0,1,1,1,1,1,0,0,1,1,1,1,1,1,1,1,1,1,1,1,1,0,1],
[0,1,1,0,0,1,1,1,1,0,0,0,0,1,1,1,1,1,0,0,0,0,0,1,0],
],
"14009":[
[0,0,1,0,0,0,0,0,0,0,0,0,0,0,0,0,0,1,1,1,1,1,0,0,0],
[1,0,1,0,1,0,0,1,0,0,0,0,0,0,0,0,0,1,0,0,0,1,1,0,0],
[0,1,1,1,0,0,0,0,0,0,1,1,1,1,1,0,0,1,1,1,0,0,1,1,1],
[1,1,0,1,1,1,0,0,0,1,1,0,0,0,1,1,0,0,1,1,0,0,0,0,1],
[0,1,1,1,0,0,0,1,1,1,0,1,1,0,0,1,0,1,1,0,0,1,0,0,1],
[1,0,1,0,1,0,1,0,0,0,1,1,0,1,0,1,1,1,1,0,1,1,1,1,1],
[0,0,1,0,0,1,0,0,1,0,0,1,1,1,0,1,0,0,1,1,1,0,0,0,0],
[0,0,0,0,0,1,0,1,0,1,0,1,1,1,1,1,0,0,0,0,1,0,0,0,0],
[0,0,1,1,1,1,0,0,1,1,1,1,1,0,0,0,1,1,0,0,1,1,1,1,0],
[0,1,1,0,0,0,1,1,1,1,0,0,0,1,0,1,0,1,1,0,1,0,0,1,1],
[0,1,0,0,1,0,0,1,1,0,0,1,0,0,1,1,0,1,0,1,1,0,0,0,1],
[0,1,0,1,0,1,0,1,1,0,1,0,1,0,1,1,0,1,1,1,1,1,1,0,1],
[0,1,0,1,1,1,1,1,1,1,1,1,0,0,1,1,1,0,0,0,1,1,1,0,1],
[0,1,1,0,0,1,1,0,0,0,1,1,1,1,1,1,0,0,1,0,0,1,0,1,1],
[0,1,1,1,1,1,0,0,1,0,0,1,1,0,0,0,1,1,0,1,0,1,1,1,0],
[1,1,0,0,0,1,0,1,0,1,0,1,0,0,1,1,0,1,1,1,0,1,1,0,0],
[1,0,0,1,1,1,0,1,1,1,0,1,0,1,1,0,0,1,0,0,1,1,1,1,0],
[1,0,1,0,1,1,1,0,0,0,1,1,0,1,1,1,0,1,1,1,1,0,0,1,0],
[1,0,0,1,1,0,1,1,1,1,1,1,1,0,0,0,1,0,0,1,0,1,0,1,0],
[1,1,0,0,0,1,0,1,1,0,1,0,1,1,1,1,0,0,1,0,1,0,0,1,0],
[0,1,1,1,1,0,0,1,1,0,1,1,0,0,1,0,0,1,1,0,1,0,1,1,1],
[1,1,1,1,1,0,1,0,1,0,0,1,1,0,1,0,1,1,1,0,1,1,1,1,1],
[1,1,1,1,1,0,0,1,1,1,0,0,0,1,1,1,0,0,0,1,1,1,1,1,1],
[0,0,1,1,1,1,0,0,0,1,1,1,1,1,1,1,1,1,1,1,1,1,1,0,0],
[0,0,0,0,0,1,1,1,1,1,1,1,1,1,1,1,1,1,1,0,0,0,0,0,0],
],
"14010":[
[0,0,0,0,0,0,0,1,1,1,1,1,1,1,1,1,1,0,0,0,0,0,0,0,0,0,0,1,1,1],
[0,0,0,0,1,1,1,1,0,0,0,0,0,0,0,0,1,1,1,0,0,0,0,0,1,1,1,1,0,1],
[0,0,1,1,1,0,0,0,0,1,0,0,1,1,1,0,0,0,1,1,1,0,0,1,1,0,0,0,0,1],
[0,1,1,0,0,0,0,0,1,0,1,0,0,1,1,1,1,0,0,0,1,1,0,1,0,0,0,1,0,1],
[0,1,0,0,0,0,0,0,0,0,1,1,1,0,0,1,1,1,1,1,0,1,1,0,0,1,1,0,1,1],
[0,1,0,0,0,0,0,0,0,1,0,1,1,1,1,1,1,1,1,1,1,1,1,1,1,0,0,0,1,0],
[1,1,0,0,0,1,1,1,0,0,1,1,1,0,0,0,0,0,0,0,0,1,1,1,0,0,0,1,1,0],
[1,0,0,0,1,1,0,1,1,1,1,0,0,0,1,1,1,1,1,1,0,0,0,1,1,1,1,1,0,0],
[1,0,0,0,1,0,1,0,1,1,1,0,1,1,1,0,0,1,0,1,1,1,0,0,0,0,1,1,0,0],
[1,0,0,0,1,1,0,1,1,1,0,0,1,1,1,1,1,0,1,1,0,1,1,1,1,0,0,1,0,0],
[1,0,0,0,0,1,1,1,1,1,0,1,1,1,1,0,0,0,1,0,1,0,1,0,1,1,0,1,1,0],
[1,0,0,0,0,0,1,1,0,1,0,1,0,0,1,1,1,1,0,1,1,0,1,0,1,1,0,0,1,0],
[1,0,1,0,0,1,1,1,0,1,0,1,1,1,0,0,0,0,1,0,1,1,0,0,1,1,1,0,1,1],
[1,0,1,0,1,0,1,0,0,1,0,1,1,0,0,1,1,1,1,1,1,1,0,1,0,0,1,0,0,1],
[1,0,0,1,0,1,1,0,0,1,0,1,1,1,1,0,0,0,1,1,0,0,1,0,1,1,1,1,0,1],
[1,1,0,1,0,1,1,0,1,1,0,1,1,1,0,1,1,1,0,1,1,1,1,0,0,0,1,1,0,1],
[0,1,0,1,1,1,1,0,1,1,0,0,1,1,1,1,1,0,1,0,1,0,1,1,1,0,0,1,0,1],
[0,1,0,0,1,1,1,0,1,1,1,0,1,0,0,1,0,1,1,0,1,0,0,0,1,1,0,1,0,1],
[0,1,1,0,1,1,0,0,0,1,1,0,1,1,0,1,1,0,1,0,1,0,1,0,0,0,1,1,0,1],
[1,1,1,0,0,1,0,0,0,0,1,1,0,1,1,1,1,1,0,1,1,0,1,0,1,1,0,1,0,1],
[1,1,1,1,1,1,0,1,0,1,1,1,1,0,0,1,1,1,1,0,1,0,0,1,0,1,1,1,0,1],
[1,1,1,1,1,1,0,0,1,0,1,0,1,1,1,0,0,1,1,1,1,1,0,1,1,1,1,0,0,1],
[0,1,1,1,1,1,0,0,0,1,0,0,1,1,1,1,1,0,0,0,1,1,1,1,1,0,0,0,1,1],
[0,0,0,0,0,1,1,0,0,0,0,0,0,1,1,0,1,1,1,1,0,0,0,0,0,0,1,1,1,1],
[0,0,0,0,0,0,1,0,0,0,0,1,0,0,1,1,1,1,1,1,1,1,1,1,1,1,0,0,1,0],
[0,0,0,0,0,0,1,0,0,1,1,0,1,0,0,1,1,1,0,0,1,1,1,1,0,0,0,1,1,0],
[0,0,0,0,0,1,1,1,0,0,0,1,1,1,1,1,1,1,1,0,0,0,0,0,0,1,1,1,1,1],
[0,0,1,1,1,1,1,1,1,1,0,0,1,1,1,1,1,0,0,0,0,0,1,1,1,1,1,1,1,1],
[0,0,0,1,1,1,1,1,1,1,1,1,0,0,0,0,0,0,0,1,1,1,1,1,1,1,1,1,1,0],
[0,0,0,0,0,0,1,1,1,1,1,1,1,1,1,1,1,1,1,1,1,1,1,1,1,1,1,0,0,0],
],
"14011":[
[1,1,0,1,1,0,0,1,1,1,0,0,0,0,0,0,1,1,0,1,1,1,1,1,0,0,0,0,0,0],
[1,0,1,0,1,0,1,1,0,0,0,1,1,1,1,1,0,0,1,1,0,0,0,1,1,1,1,0,0,0],
[1,1,0,1,1,0,1,0,0,1,1,1,0,1,0,1,1,0,1,0,1,1,1,0,0,0,1,1,1,1],
[0,1,1,1,0,1,1,0,1,1,0,1,0,1,0,0,0,1,1,0,0,0,1,1,1,1,0,0,0,1],
[0,0,0,0,0,1,0,1,1,1,0,0,0,0,1,1,1,1,1,1,0,0,1,0,1,1,1,1,1,0],
[0,0,0,0,0,1,0,1,0,1,0,1,1,1,1,0,0,1,1,0,1,0,1,0,1,0,1,0,0,0],
[1,1,0,0,0,1,0,1,0,0,1,1,1,0,0,1,1,1,0,0,1,0,0,0,1,0,1,1,1,1],
[0,1,1,0,0,1,0,0,1,1,1,1,1,0,1,1,1,1,0,1,1,1,0,0,1,0,1,1,1,0],
[1,0,1,0,0,1,1,1,1,1,0,1,1,0,1,1,1,1,0,1,0,1,0,0,1,0,1,0,1,0],
[0,1,1,1,0,0,0,1,1,0,1,1,0,1,1,1,1,0,0,1,0,1,1,0,1,0,1,0,1,1],
[1,1,0,1,1,0,0,1,0,1,1,1,0,1,1,1,1,0,1,1,0,0,1,0,0,0,1,0,1,1],
[1,0,1,0,1,0,1,1,0,1,1,1,0,1,1,1,1,0,1,0,0,0,1,0,0,0,1,0,1,1],
[1,1,0,1,1,0,1,0,1,1,1,1,0,1,1,1,1,0,1,0,0,0,1,1,1,0,0,0,1,0],
[0,1,1,1,0,0,1,0,1,1,1,1,0,1,1,1,1,0,1,0,0,0,0,0,1,1,0,0,0,0],
[0,0,0,0,0,1,1,0,1,0,0,1,0,1,0,1,1,0,1,0,0,0,0,0,0,1,1,1,1,0],
[0,0,0,0,0,1,0,1,1,0,0,1,1,0,0,0,1,0,1,0,0,0,0,0,0,0,0,0,1,1],
[0,0,0,1,1,1,0,1,1,1,1,0,0,1,0,1,1,0,1,0,0,0,0,0,0,0,0,0,0,0],
[0,1,1,1,0,1,0,1,0,1,1,0,1,0,1,1,1,0,1,1,1,1,0,0,0,0,0,1,1,1],
[0,1,0,0,0,1,0,1,0,0,0,1,1,1,1,1,1,0,1,0,0,1,1,1,0,0,1,1,0,1],
[1,1,0,1,0,0,1,0,0,0,0,1,1,1,0,0,1,0,1,1,0,0,0,1,1,0,1,0,1,0],
[1,0,1,0,0,0,0,0,0,0,0,0,1,0,0,0,0,1,1,0,0,1,1,0,1,0,1,1,0,1],
[1,0,1,1,0,0,0,0,0,0,1,1,1,0,1,0,0,0,0,0,1,1,1,0,1,1,0,1,1,1],
[1,0,1,1,0,1,0,0,1,1,1,1,0,1,1,0,0,0,0,0,0,1,1,1,0,1,0,0,0,0],
[1,0,0,1,1,0,1,0,0,0,1,1,0,1,0,1,1,0,0,0,1,0,1,1,0,1,0,0,0,0],
[1,1,0,1,1,1,1,1,1,1,0,1,0,1,1,1,1,1,0,0,0,1,1,1,0,1,0,0,0,0],
[0,1,0,0,1,1,1,1,0,0,1,1,0,1,1,1,0,0,0,1,1,1,0,1,0,1,0,0,0,0],
[1,1,1,1,0,0,0,0,1,1,1,1,1,0,1,1,1,1,1,0,0,1,1,0,1,1,1,1,1,0],
[1,1,1,1,1,1,1,1,1,1,1,1,1,0,0,1,1,1,1,1,0,0,0,0,1,1,1,1,1,1],
[0,0,0,0,1,1,1,1,1,1,1,1,1,1,1,0,0,0,0,0,0,0,1,1,1,1,1,1,1,1],
[0,0,0,0,0,0,0,0,0,0,0,0,1,1,1,1,1,1,1,1,1,1,1,1,1,1,1,1,1,1],
],
"14012":[
[0,0,0,1,1,1,1,1,1,1,1,1,0,0,0,0,0,0,0,0,0,0,0,1,1,1,0,0,0,0],
[0,1,1,1,0,0,0,0,0,0,0,1,1,1,1,0,0,0,0,0,0,0,0,1,0,1,0,0,0,0],
[1,1,0,0,0,1,1,0,0,0,0,0,0,0,1,1,1,0,0,0,0,0,1,1,0,1,1,0,0,0],
[1,0,0,0,1,0,1,1,1,0,0,0,0,1,0,0,1,1,0,0,0,0,1,1,1,0,1,0,0,0],
[1,0,0,0,1,1,1,0,0,1,1,0,1,1,1,0,0,1,0,0,0,0,1,0,1,0,1,0,0,0],
[0,0,1,0,0,0,0,1,1,1,0,0,0,0,1,1,0,1,1,0,0,1,1,0,1,1,1,1,0,0],
[0,0,1,0,1,0,0,0,0,1,1,1,0,1,1,1,0,0,1,1,0,1,1,1,0,1,1,1,0,0],
[0,1,0,0,1,0,0,0,0,0,1,0,1,0,0,1,1,0,0,1,0,1,1,1,0,1,0,1,0,0],
[1,1,0,0,1,1,0,1,0,0,1,1,1,0,1,1,1,0,0,1,1,1,0,1,1,1,0,1,1,0],
[1,1,0,0,1,1,1,1,0,1,1,1,0,1,0,1,1,1,0,1,1,1,0,1,1,1,1,1,1,0],
[1,1,0,1,1,1,1,1,0,0,1,1,1,1,0,0,0,1,0,0,1,0,1,1,1,1,1,1,1,1],
[1,0,0,0,0,1,1,1,0,0,0,0,1,1,1,0,1,1,1,0,1,0,0,0,0,1,1,0,1,1],
[1,1,1,0,1,1,1,0,0,0,0,1,1,1,0,0,0,1,1,0,1,0,1,1,1,0,0,1,0,1],
[1,1,0,0,0,1,1,1,1,0,0,0,0,1,1,0,1,1,1,1,1,1,0,0,0,1,0,1,0,1],
[1,0,1,0,1,1,1,1,0,0,0,1,1,1,1,1,1,1,1,0,0,0,1,1,1,1,0,1,0,1],
[1,1,1,1,0,0,1,1,1,1,1,1,1,1,1,0,0,0,0,1,1,1,1,0,1,0,0,1,0,1],
[1,1,1,1,1,1,1,1,1,1,1,0,0,0,0,1,1,1,1,1,1,0,1,0,1,0,1,1,0,1],
[1,1,1,1,1,1,1,0,0,0,0,1,1,0,1,1,1,0,1,0,1,1,0,1,1,0,1,1,0,1],
[1,1,1,0,0,0,0,1,0,1,1,1,1,0,1,0,1,0,1,0,1,1,0,1,1,0,1,1,0,1],
[1,1,1,0,1,0,1,1,0,1,0,1,1,1,1,0,1,1,1,0,1,1,1,1,1,0,1,1,0,1],
[0,1,1,0,1,0,1,1,1,1,0,1,0,1,1,1,0,1,0,1,1,0,1,1,0,1,1,1,0,1],
[0,1,1,0,1,0,1,1,1,1,1,1,0,1,0,1,0,1,0,1,0,1,1,0,0,1,1,0,1,1],
[0,0,1,0,0,1,0,0,1,1,1,1,1,1,1,0,1,1,1,1,1,1,0,0,1,1,0,0,1,0],
[1,0,0,1,0,1,1,1,0,0,0,0,1,1,1,1,1,1,1,0,0,0,1,1,1,1,1,0,1,0],
[1,1,1,1,0,0,1,1,1,1,1,1,0,0,0,0,0,0,0,1,1,1,1,1,1,0,0,0,1,0],
[1,1,1,1,0,1,0,1,1,0,1,1,1,1,1,1,1,1,1,1,1,1,0,1,0,0,0,1,0,0],
[1,1,1,1,1,0,0,0,0,1,0,1,0,1,0,1,1,0,1,1,0,0,1,0,0,1,1,1,1,1],
[0,0,0,0,1,1,1,1,0,0,0,0,0,0,1,0,0,1,0,0,0,0,0,1,1,1,1,1,1,1],
[0,0,0,0,0,0,1,1,1,1,1,1,1,0,0,0,0,0,0,1,1,1,1,1,1,1,1,1,1,1],
[0,0,0,1,1,1,1,1,1,1,1,1,1,1,1,1,1,1,1,1,1,1,1,0,0,0,0,0,0,0],
],}