{"15701":[
[0,0,0,1,1,0,1,1,0,0,0,0,0,0,0,0,1,1,1,0,0,1,0,1,0],
[0,0,1,1,0,1,1,1,1,0,0,0,0,0,0,0,1,0,1,0,0,1,1,1,0],
[0,0,1,1,1,1,1,1,1,0,0,0,0,0,0,1,1,0,1,0,0,0,1,0,0],
[0,0,0,1,1,1,1,1,0,0,0,0,1,1,1,1,0,1,1,0,0,0,0,0,0],
[1,0,1,0,1,1,1,0,0,0,0,1,1,0,0,0,0,0,1,1,1,0,0,0,0],
[1,1,1,0,0,1,0,0,0,0,0,1,0,0,0,0,0,0,0,0,1,0,0,0,0],
[0,1,0,0,0,0,0,0,0,0,0,1,0,0,0,0,0,0,0,0,1,0,0,0,0],
[0,0,0,0,0,0,0,0,0,0,1,1,0,1,0,0,1,0,0,0,1,1,0,0,0],
[1,1,1,1,0,0,1,0,1,0,1,0,0,1,0,0,1,0,1,0,0,1,0,0,0],
[1,0,0,1,0,0,1,1,1,0,1,0,0,0,0,0,0,0,1,0,0,1,0,0,0],
[1,0,0,1,1,0,0,1,0,0,1,0,0,0,0,0,0,0,1,0,0,1,0,0,0],
[1,0,1,0,1,1,1,0,0,0,1,0,1,0,0,0,0,0,1,1,0,1,0,0,0],
[1,0,1,1,0,0,1,1,1,1,1,0,1,0,0,1,0,0,1,1,0,1,0,0,0],
[1,1,0,1,1,0,0,0,0,0,1,0,1,1,0,1,0,1,0,1,0,1,0,1,1],
[0,1,0,1,1,1,0,1,0,1,1,0,1,0,1,1,0,1,1,0,0,1,1,1,0],
[0,1,0,0,1,1,1,0,1,1,0,0,1,1,0,1,0,1,1,1,0,1,0,0,0],
[1,1,1,0,0,0,1,1,1,1,0,0,1,1,1,0,0,1,1,0,0,1,0,0,0],
[1,1,1,1,1,1,0,0,1,1,0,1,1,1,1,0,1,1,0,1,0,1,1,0,0],
[1,1,1,1,1,1,1,1,1,0,0,1,0,1,0,1,1,1,1,0,0,0,1,0,0],
[0,0,0,0,0,1,1,0,0,0,1,0,1,0,0,1,0,1,1,0,1,0,1,1,1],
[0,1,1,1,1,0,0,0,1,1,1,0,0,0,1,1,1,0,1,1,0,0,1,1,1],
[1,0,0,0,0,0,1,1,1,1,0,0,1,1,1,1,1,0,0,1,1,0,1,0,0],
[1,0,0,1,1,1,1,0,0,0,0,1,1,1,1,1,1,1,1,0,0,0,0,1,1],
[1,1,0,0,0,0,0,0,1,1,1,1,1,1,0,0,1,1,1,1,1,0,0,0,0],
[1,1,1,1,1,1,1,1,1,1,1,1,0,0,0,0,0,0,0,1,1,1,1,1,1],
],
"15702":[
[0,0,0,0,0,0,1,1,1,1,1,1,0,0,0,0,0,0,0,0,0,0,0,0,1],
[0,1,1,1,0,1,1,0,0,0,0,1,1,1,0,0,0,0,0,0,0,1,1,1,1],
[0,1,0,1,0,1,0,0,1,0,1,0,0,1,0,0,0,0,0,0,0,0,0,0,1],
[0,1,0,0,0,1,0,0,1,0,1,0,0,1,1,0,0,1,1,1,1,1,0,0,0],
[1,1,0,0,0,1,1,0,0,1,0,0,1,0,1,0,1,1,0,0,0,1,1,1,0],
[1,1,0,0,0,0,1,1,0,0,0,0,1,0,1,1,1,0,0,0,0,0,0,1,0],
[0,0,1,1,1,1,1,1,0,0,1,0,0,1,0,1,0,0,0,0,1,1,0,1,1],
[0,1,1,0,0,0,1,1,0,0,0,1,0,1,0,1,1,0,0,1,1,1,1,0,1],
[1,1,0,1,1,1,1,1,1,0,0,1,0,1,1,1,1,1,1,1,1,0,0,0,1],
[1,0,1,0,0,0,0,1,1,0,1,1,1,1,1,1,1,1,0,0,0,1,1,1,1],
[1,0,1,0,1,1,1,1,1,1,1,1,1,1,1,0,0,0,0,1,0,0,1,0,0],
[1,0,0,1,1,1,1,0,0,0,0,0,1,0,1,1,1,1,0,0,1,0,1,1,0],
[1,0,1,1,0,1,0,0,1,0,0,0,0,1,0,0,0,1,1,0,1,1,0,1,0],
[0,1,1,0,0,1,0,1,0,0,1,1,1,1,0,1,0,1,1,0,0,1,0,1,0],
[0,0,0,0,1,1,0,1,0,0,1,1,0,0,0,0,1,0,1,1,0,1,0,1,0],
[0,0,0,0,1,0,1,0,1,1,1,0,0,0,1,0,1,0,1,1,0,0,1,1,0],
[0,0,0,0,1,0,1,0,1,1,1,0,0,0,0,1,1,0,1,1,0,0,1,0,0],
[0,1,0,0,1,0,1,0,1,0,1,1,0,0,1,0,1,0,1,1,1,1,1,0,0],
[0,1,0,0,1,1,0,0,1,0,0,1,0,0,1,1,1,0,1,0,0,0,0,0,0],
[0,1,0,0,0,1,0,1,1,0,0,1,0,0,1,1,1,0,1,0,0,0,0,0,0],
[1,0,1,1,0,1,1,1,0,0,1,1,0,1,1,1,0,1,1,0,0,0,0,0,0],
[1,1,0,0,0,0,0,0,0,0,1,0,1,1,1,0,0,1,1,0,0,0,0,0,0],
[0,0,0,0,1,1,1,1,1,1,1,0,0,0,0,0,1,1,1,1,1,1,1,0,0],
[1,1,1,1,1,1,1,1,1,0,0,0,1,1,1,1,1,1,1,1,1,1,1,1,0],
[0,0,1,1,1,1,1,1,1,1,1,1,1,1,1,1,1,1,1,1,1,1,0,0,0],
],
"15703":[
[0,0,0,0,1,1,1,1,1,1,1,0,0,0,1,1,1,1,1,1,1,0,0,0,0],
[0,0,1,1,1,1,1,1,1,1,1,1,0,1,1,1,1,1,1,1,1,1,1,0,0],
[0,0,1,1,0,0,0,0,0,0,1,1,0,1,1,0,0,0,0,0,0,1,1,0,0],
[0,1,1,0,0,1,1,1,1,1,0,1,1,1,0,1,1,1,1,1,0,0,1,1,0],
[0,1,1,0,1,1,0,0,0,1,1,0,1,0,1,1,0,0,0,1,1,0,1,1,0],
[0,1,0,1,1,0,0,0,0,0,1,0,1,0,1,0,0,0,0,0,1,1,0,1,0],
[1,1,0,1,0,0,1,1,1,0,1,1,0,1,1,0,1,1,1,0,0,1,0,1,1],
[1,1,0,1,0,1,1,1,1,1,0,1,0,1,0,1,1,1,1,1,0,1,0,1,1],
[1,1,0,1,0,1,1,1,1,1,1,0,1,0,1,0,1,1,1,1,0,1,0,1,1],
[1,1,0,1,0,1,1,1,1,1,1,1,0,1,1,0,1,1,1,1,0,1,0,1,1],
[1,1,0,1,0,0,1,1,1,0,0,1,1,0,0,1,0,0,1,0,0,1,0,1,1],
[1,1,0,1,1,0,1,1,1,0,0,0,0,1,1,0,1,1,1,0,1,1,0,1,1],
[0,1,1,0,1,0,0,1,1,1,0,0,0,1,1,1,1,1,0,0,1,0,1,1,0],
[0,1,1,0,1,1,0,0,1,1,0,1,1,0,0,0,1,1,0,1,1,0,1,1,0],
[0,0,1,1,0,1,0,1,1,0,0,0,0,0,0,0,0,1,0,1,0,1,1,0,0],
[0,0,1,1,0,1,1,1,0,0,0,0,0,0,0,0,0,1,1,1,0,1,1,0,0],
[0,0,0,1,1,0,1,1,0,0,0,0,0,0,0,0,0,0,1,0,1,1,0,0,0],
[0,0,0,1,1,1,1,0,0,0,1,0,0,0,1,0,1,0,1,1,1,1,0,0,0],
[0,0,0,0,1,1,1,0,0,0,1,0,0,0,1,0,1,0,1,1,1,0,0,0,0],
[1,1,1,0,0,0,1,0,0,0,0,1,1,1,0,0,1,0,1,0,0,0,1,1,1],
[0,1,0,0,0,0,1,1,0,1,0,0,0,0,0,0,1,0,1,0,0,0,0,1,0],
[0,1,1,0,0,0,0,1,0,1,0,0,0,0,1,1,1,0,1,0,0,0,0,1,1],
[0,1,1,0,0,1,0,1,0,1,0,0,0,1,0,1,1,0,1,0,1,0,1,1,1],
[0,1,1,1,1,1,0,1,0,0,1,1,0,0,1,1,0,1,0,0,1,1,1,1,1],
[0,0,1,1,1,0,0,1,1,0,1,1,0,1,1,1,0,1,0,0,0,1,1,1,0],
],
"15704":[
[1,1,1,1,1,1,1,1,1,1,1,1,1,1,1,1,1,1,1,0,1,0,0,1,1,1,0,0,0,1],
[0,0,0,0,0,0,1,1,1,1,1,1,1,1,1,1,1,1,0,0,1,0,0,0,0,1,1,1,0,1],
[0,1,1,1,1,0,0,0,0,1,1,1,1,1,1,1,1,0,0,1,1,1,1,0,0,0,0,1,0,1],
[1,1,0,0,1,1,1,1,0,0,0,0,1,1,0,0,0,0,1,1,0,1,1,1,1,0,0,1,0,1],
[1,0,1,1,0,0,0,1,1,1,1,0,0,0,0,1,1,1,1,0,1,0,1,0,1,1,1,1,0,1],
[1,0,1,1,0,0,0,0,0,0,1,1,1,1,1,1,0,0,0,1,1,0,1,0,1,0,1,0,0,1],
[1,1,0,1,1,1,0,0,0,0,0,0,0,0,0,0,0,0,1,1,0,1,1,0,1,0,1,1,0,1],
[0,1,0,0,0,1,1,1,1,0,0,1,0,1,0,0,1,1,1,1,0,1,1,0,1,1,0,1,0,0],
[0,0,1,1,0,0,0,0,1,1,1,1,1,1,1,1,1,1,1,0,0,1,0,0,1,1,0,1,1,0],
[0,1,1,1,1,1,1,0,0,0,0,0,1,1,1,1,0,0,0,0,1,0,0,0,1,1,0,0,1,0],
[1,1,0,0,1,1,1,1,1,1,1,1,1,1,0,0,0,0,0,1,1,0,0,1,0,1,0,0,1,1],
[1,0,1,1,0,0,1,1,1,1,1,1,0,0,0,1,0,1,1,1,0,1,0,0,1,1,0,0,0,1],
[1,0,1,0,0,0,0,0,0,0,0,0,0,0,1,0,1,1,1,0,1,1,0,1,1,1,0,1,0,1],
[1,0,0,0,0,1,0,0,0,1,0,1,1,1,0,1,1,0,0,1,1,0,0,1,1,0,0,1,0,1],
[1,1,0,1,1,0,1,1,1,1,1,0,1,1,1,1,0,0,1,1,0,0,1,0,1,0,1,1,0,1],
[0,1,1,1,1,1,1,1,1,1,1,1,1,0,0,0,0,1,1,0,0,0,1,1,1,0,1,1,0,1],
[0,1,1,0,0,0,1,1,1,1,1,0,0,0,0,1,1,1,0,1,0,1,0,1,0,0,1,1,0,1],
[0,1,0,1,1,0,0,0,0,0,0,0,1,1,1,1,0,0,1,0,1,1,1,1,0,1,0,1,0,1],
[0,1,0,1,1,0,0,0,1,1,1,1,1,0,0,0,0,0,0,1,1,1,1,0,0,0,1,1,0,1],
[0,1,1,0,0,0,0,0,0,0,0,0,0,0,0,1,1,1,1,1,1,1,0,0,0,0,1,0,1,1],
[0,0,1,0,0,0,0,0,0,0,0,0,0,1,0,0,0,1,1,1,1,0,0,0,0,1,1,0,1,0],
[0,0,1,1,1,0,0,1,0,1,0,0,1,0,1,0,1,1,1,1,0,0,0,0,1,1,1,0,1,0],
[0,0,1,1,1,1,1,1,1,0,1,1,1,1,1,1,1,1,0,0,0,0,0,0,1,1,1,0,1,0],
[0,1,1,1,0,0,1,1,1,1,1,1,1,1,1,1,1,0,0,0,0,0,0,1,1,1,0,0,1,0],
[1,1,1,0,1,1,0,0,0,0,1,1,1,1,1,1,0,0,1,0,0,1,0,1,1,1,0,1,1,0],
[1,1,1,0,1,1,0,0,0,1,0,0,1,1,0,0,1,0,1,0,1,1,1,1,1,0,0,1,0,0],
[1,1,1,1,0,1,0,1,1,1,1,1,1,1,0,1,1,0,1,1,1,1,1,0,0,0,1,1,0,0],
[1,1,1,1,0,0,0,0,1,1,1,1,0,1,0,1,1,0,1,1,0,0,0,0,1,1,1,1,1,0],
[1,1,1,1,1,1,1,0,0,0,0,0,1,1,1,0,0,0,0,0,1,1,1,1,1,1,1,1,1,1],
[0,0,1,1,1,1,1,1,1,1,1,1,1,1,1,1,1,1,1,1,1,1,1,1,1,1,1,1,1,1],
],
"15705":[
[1,1,1,1,1,1,1,1,1,1,1,1,1,1,1,0,0,0,0,0,0,0,0,0,0,1,1,1,0,0],
[1,1,1,1,1,1,1,0,0,0,0,0,0,0,1,1,1,1,0,0,0,0,0,0,0,0,1,0,0,0],
[1,1,1,1,0,0,0,0,0,1,1,1,1,1,0,0,0,1,1,0,0,0,0,0,0,1,1,0,0,0],
[1,1,1,0,0,1,1,0,0,0,0,0,1,1,1,1,0,0,1,0,0,1,1,0,0,1,1,0,0,0],
[1,1,1,0,1,1,0,0,0,0,0,0,0,1,0,1,1,0,1,1,0,1,1,1,1,1,1,0,0,0],
[1,1,0,1,1,0,1,0,0,1,1,0,0,0,1,0,1,1,0,1,0,0,1,1,1,1,0,0,0,0],
[1,1,0,1,0,0,0,0,1,0,1,1,0,0,0,0,0,1,0,1,0,0,0,0,0,0,0,0,0,0],
[1,1,0,1,1,0,0,0,1,1,1,0,0,1,1,0,1,1,0,1,1,0,0,0,1,1,1,0,0,0],
[1,0,1,1,0,0,1,1,0,1,0,1,1,0,1,0,0,1,1,0,1,0,0,0,0,1,0,0,0,0],
[1,0,1,1,0,1,1,0,1,0,1,1,1,1,1,0,1,1,1,0,1,0,0,0,0,1,1,0,1,1],
[1,0,1,0,0,1,1,1,0,1,1,1,0,0,0,1,1,1,1,1,1,1,1,1,0,1,1,1,1,1],
[1,0,0,0,0,0,0,0,0,1,1,0,1,1,1,1,0,0,0,0,0,0,0,1,1,1,1,1,1,0],
[1,1,0,1,0,0,0,0,0,0,1,1,1,0,0,0,0,0,0,0,1,1,1,0,0,0,1,0,0,0],
[0,1,0,1,1,1,0,0,0,0,0,1,0,0,1,1,0,0,0,0,0,0,1,1,1,1,0,1,0,0],
[0,1,0,1,1,0,0,1,0,0,1,1,0,1,1,0,0,0,0,0,0,0,0,0,1,1,0,1,1,0],
[0,1,1,0,1,1,1,1,1,0,1,0,1,1,1,0,0,0,1,1,0,0,0,0,0,1,1,0,1,0],
[0,0,1,0,0,1,1,1,1,1,1,0,1,1,0,0,0,1,0,1,1,0,0,0,0,1,1,0,1,0],
[0,0,1,1,0,0,0,1,1,1,1,0,1,0,1,0,0,1,1,1,1,0,1,1,1,0,1,0,1,1],
[0,0,0,1,1,1,1,0,0,1,0,1,1,1,0,0,0,0,1,1,0,1,0,0,1,0,1,1,0,1],
[1,1,1,0,0,0,1,1,1,1,0,1,1,0,0,0,1,1,1,1,1,0,1,1,1,0,0,1,0,1],
[0,1,0,0,0,0,0,0,0,1,0,1,1,0,0,1,0,0,1,0,1,1,1,1,0,0,1,1,0,1],
[0,1,1,0,0,0,0,0,0,1,0,0,1,0,0,1,1,0,1,1,1,1,0,0,0,1,1,1,0,1],
[0,1,1,0,1,1,0,0,0,1,1,0,1,0,0,1,1,1,0,1,0,1,1,1,0,0,1,0,1,1],
[0,1,1,1,1,1,0,0,0,0,1,0,1,1,0,0,0,0,0,1,1,0,0,1,0,0,1,0,1,1],
[0,0,1,1,1,0,0,0,0,0,1,0,1,1,0,0,0,0,0,0,1,1,1,1,0,1,1,0,1,1],
[0,0,0,0,0,0,1,1,1,0,1,1,0,1,0,1,0,1,0,0,0,0,0,0,0,1,0,1,1,1],
[0,0,0,0,0,0,0,1,0,0,0,1,0,0,1,1,1,1,1,0,0,0,0,0,1,0,0,1,1,1],
[0,0,1,1,0,0,1,1,0,0,0,1,1,0,0,0,1,1,1,1,1,0,0,0,0,0,1,1,1,1],
[0,0,1,1,1,1,1,1,0,0,0,0,1,1,1,1,0,0,0,0,0,0,0,1,1,1,1,1,1,1],
[0,0,0,1,1,1,1,0,0,0,0,0,0,0,0,1,1,1,1,1,1,1,1,1,1,1,1,1,1,1],
],
"15706":[
[1,1,1,0,0,0,1,1,0,0,0,0,0,0,0,0,0,1,1,1,1,1,1,1,1,1,1,1,1,1],
[1,1,0,0,1,1,0,1,0,0,0,1,1,1,0,0,0,1,0,0,0,1,1,1,1,1,1,0,0,0],
[1,1,0,1,0,1,0,1,0,0,0,1,1,1,0,0,0,1,1,1,0,0,0,0,1,1,1,0,1,0],
[1,1,0,0,1,1,0,1,0,0,0,0,0,1,0,0,0,0,0,1,0,1,1,1,1,1,1,0,1,1],
[1,1,1,0,0,0,1,1,1,0,0,0,0,1,0,0,0,0,0,1,0,1,0,1,1,1,0,0,1,1],
[1,1,1,1,1,1,1,1,1,1,1,0,0,1,0,0,1,1,1,1,1,1,1,0,1,1,0,0,1,1],
[1,1,0,0,0,0,0,1,1,0,1,0,0,0,0,1,1,0,0,0,0,0,1,0,1,1,1,1,1,1],
[1,1,0,0,0,0,0,0,1,0,1,1,0,0,0,1,0,0,0,0,0,0,1,1,0,1,1,1,1,1],
[1,0,0,1,1,1,0,0,0,1,1,1,0,0,0,1,0,0,0,0,0,0,0,1,0,0,1,1,1,1],
[1,0,0,1,0,1,0,0,0,1,0,0,0,1,1,1,1,1,1,1,1,1,1,1,1,1,0,1,1,1],
[0,0,0,1,0,0,0,0,0,1,1,0,0,1,1,1,1,1,1,0,1,0,0,1,0,1,0,1,1,1],
[0,1,1,1,0,0,0,0,0,0,1,0,0,1,1,1,0,1,1,1,1,0,0,1,0,0,0,0,1,1],
[0,1,1,1,0,0,0,1,0,0,1,1,0,0,1,0,1,0,0,0,0,0,0,1,0,0,0,0,0,0],
[0,0,0,0,0,0,1,1,0,0,0,1,1,1,1,0,1,0,0,0,0,1,1,1,1,1,1,1,0,0],
[0,0,0,0,1,1,1,1,1,0,0,0,0,1,0,0,0,0,0,1,0,0,1,1,0,0,0,1,1,0],
[0,1,0,0,1,1,1,1,1,1,1,0,0,1,0,0,0,0,1,0,1,1,1,1,1,1,0,0,1,1],
[1,1,0,0,0,0,1,1,1,0,0,0,1,1,0,0,0,0,1,1,1,0,0,0,0,1,1,0,0,1],
[1,1,1,1,1,1,0,0,0,0,0,0,1,0,0,0,0,1,1,1,0,0,1,0,1,0,1,0,0,1],
[1,1,1,0,0,1,1,1,0,0,0,1,1,0,0,0,1,0,1,1,0,1,0,1,1,0,1,0,0,1],
[1,1,1,0,0,0,0,1,1,0,1,1,0,0,0,0,0,1,1,1,0,1,1,1,0,0,1,0,0,1],
[0,0,0,0,0,0,0,0,1,1,1,0,0,0,0,0,0,1,1,1,0,0,1,1,1,0,1,0,1,1],
[0,0,0,0,0,1,1,1,1,0,0,0,0,0,0,0,1,1,1,1,1,0,0,0,0,1,1,1,1,0],
[1,0,0,1,1,1,0,0,0,0,0,0,0,1,0,1,1,1,1,0,1,1,1,1,1,1,0,1,0,0],
[1,1,1,1,0,0,1,1,0,1,0,0,1,0,1,1,1,1,1,0,1,0,0,0,0,1,0,1,0,0],
[1,1,1,0,1,1,0,1,1,0,0,1,1,1,1,1,0,0,1,1,0,0,0,0,0,1,1,1,1,0],
[1,1,1,0,1,1,0,1,1,1,1,1,1,1,1,0,0,1,1,1,1,0,0,0,0,0,0,1,1,1],
[1,1,1,0,0,0,1,1,1,1,1,0,0,0,0,1,1,1,0,0,1,0,0,0,0,0,0,0,1,1],
[1,1,1,1,1,0,0,0,0,0,0,0,1,1,1,1,0,0,0,0,1,1,1,0,0,0,0,0,0,0],
[1,1,1,1,1,1,1,1,1,1,1,1,1,1,1,1,1,1,1,0,0,1,1,1,1,0,0,0,0,0],
[1,1,1,1,1,1,1,1,1,1,1,1,1,1,1,1,1,1,1,1,0,1,1,1,1,0,0,0,0,0],
],
"15707":[
[0,0,0,1,1,1,0,0,1,1,1,0,0,0,1,1,1,0,0,1,1,0,0,0,0],
[0,0,0,1,1,1,1,0,0,0,1,1,0,1,1,0,0,1,1,1,1,0,0,0,0],
[0,0,0,0,0,1,1,1,1,0,0,1,1,1,0,0,1,1,1,0,0,0,0,0,0],
[0,1,1,1,1,0,1,1,1,1,0,0,1,0,0,1,1,1,0,1,1,1,1,1,0],
[1,0,0,0,0,1,1,0,0,0,0,1,1,0,1,1,0,1,1,1,0,0,0,0,1],
[1,1,1,1,1,0,0,0,0,1,1,0,0,0,0,1,0,0,0,0,0,1,1,1,1],
[0,0,1,1,1,1,1,1,1,0,0,1,0,1,0,0,1,1,1,1,1,1,1,0,0],
[0,0,0,0,1,1,1,1,0,1,0,1,1,1,1,0,0,1,1,1,1,1,0,0,0],
[0,1,1,1,1,0,0,0,0,1,1,1,0,1,1,1,0,0,0,0,0,1,1,1,0],
[0,1,0,0,0,0,0,1,1,1,1,0,0,0,1,1,1,1,0,0,1,0,0,1,0],
[0,1,1,1,1,1,1,1,1,1,0,0,1,0,0,1,1,1,1,1,0,0,1,1,0],
[0,0,0,1,1,1,1,1,0,0,0,1,1,1,0,0,0,1,1,1,1,1,0,0,0],
[0,0,1,1,0,0,0,0,0,1,0,0,1,0,0,1,0,0,0,0,0,1,1,0,0],
[0,0,1,0,0,0,1,0,1,0,1,1,0,1,1,0,1,1,0,1,0,0,1,0,0],
[0,0,1,0,1,0,1,1,0,1,1,1,0,1,1,1,1,0,1,0,1,0,1,0,0],
[0,0,1,0,0,1,0,1,0,1,1,1,1,1,1,1,1,0,1,1,0,0,1,0,0],
[0,0,1,0,1,0,1,1,1,1,0,1,1,1,0,1,1,1,1,1,1,0,1,0,0],
[0,0,1,0,0,1,1,1,1,1,0,1,1,1,0,1,1,1,1,1,0,0,1,0,0],
[0,1,1,0,0,1,1,0,0,1,1,0,0,0,1,1,0,0,1,0,0,0,1,1,0],
[1,1,1,1,0,0,1,1,1,1,1,1,1,1,1,1,1,1,1,1,0,1,1,1,1],
[1,0,1,1,0,1,0,1,0,1,1,1,0,1,1,0,1,1,0,1,0,1,1,0,1],
[1,0,0,1,0,0,1,1,0,1,0,1,1,1,1,0,1,1,1,0,0,1,0,0,1],
[1,0,0,1,1,0,0,0,1,1,0,1,1,0,1,1,1,0,1,0,1,1,0,0,1],
[1,1,1,0,1,0,0,1,0,1,1,0,1,0,1,1,0,1,0,0,1,0,1,1,0],
[0,1,1,0,1,1,0,0,1,1,1,0,1,1,0,0,1,0,0,1,1,0,1,1,0],
],
"15708":[
[0,0,0,0,0,0,0,0,0,0,0,1,1,1,1,1,1,1,1,1,0,0,0,0,0],
[0,0,0,0,0,0,1,1,1,1,1,0,0,0,0,1,0,0,0,1,1,1,1,0,0],
[0,0,0,1,1,1,1,0,0,0,0,1,1,1,0,1,1,1,1,0,0,0,1,1,0],
[0,0,0,0,1,0,0,1,1,1,1,0,0,0,1,0,0,0,1,1,1,1,0,1,0],
[0,0,1,1,0,1,0,0,0,0,0,0,1,1,0,1,0,0,0,0,0,1,0,1,1],
[0,0,0,1,0,1,1,1,1,0,1,0,1,1,0,1,0,0,0,0,0,1,1,0,1],
[0,0,1,0,0,0,0,0,0,0,1,0,1,0,1,1,0,0,0,0,0,0,1,0,1],
[0,0,0,1,1,1,1,1,0,0,0,1,0,1,0,0,0,0,0,0,1,1,0,1,1],
[0,1,1,0,0,0,0,0,1,1,0,1,0,0,1,0,0,1,1,1,0,1,1,1,1],
[0,0,1,1,1,1,1,0,0,1,0,1,1,0,1,0,0,1,0,0,0,0,0,0,1],
[0,1,0,1,0,0,0,1,0,1,1,0,1,0,1,0,0,1,1,1,1,1,0,0,0],
[0,0,1,0,1,1,0,1,0,0,1,0,1,0,1,0,0,1,1,0,0,1,1,1,0],
[0,1,1,1,0,0,0,1,1,0,1,0,0,1,0,0,1,1,0,0,1,0,1,1,1],
[0,0,1,0,1,0,1,0,1,0,0,1,0,1,0,0,1,0,0,0,0,1,1,0,1],
[0,1,0,1,1,0,1,0,1,1,0,1,0,1,0,1,1,0,0,1,1,1,1,0,1],
[0,1,0,1,0,1,0,1,0,1,0,0,1,1,0,1,0,0,1,1,0,1,0,1,1],
[1,0,1,1,1,1,0,1,0,0,1,1,1,0,0,1,0,1,0,1,0,1,1,1,0],
[1,0,1,0,1,1,0,1,0,1,1,0,1,0,1,1,0,0,1,1,1,0,1,1,0],
[1,0,1,1,0,0,1,0,1,1,0,1,0,0,1,0,0,1,0,1,1,1,1,1,1],
[1,1,1,0,1,1,1,1,0,1,0,0,0,0,1,0,1,1,0,1,1,0,1,0,1],
[0,0,1,0,1,0,0,1,0,0,0,0,0,0,1,0,1,1,1,0,1,1,0,1,0],
[0,0,0,0,0,0,0,0,0,0,0,0,0,0,1,0,0,1,0,1,0,1,1,0,0],
[0,0,0,0,0,0,0,0,0,0,0,0,1,1,1,1,0,1,1,0,0,0,0,0,1],
[0,1,1,1,0,0,0,0,1,1,1,1,1,1,1,1,0,0,0,0,1,1,1,1,1],
[1,1,1,1,1,1,1,1,0,0,1,1,1,1,1,1,1,1,1,1,1,1,1,1,1],
],
"15709":[
[1,1,1,0,0,1,1,1,1,0,0,1,1,1,1,1,1,1,1,0,1,1,1,1,1],
[1,1,1,1,0,0,1,0,0,0,0,0,1,1,1,1,0,0,0,0,0,1,1,1,1],
[1,0,0,0,0,0,0,0,0,0,1,1,1,1,0,0,0,1,0,1,0,0,0,1,1],
[1,1,0,0,1,1,0,1,1,1,1,1,1,1,0,1,1,0,1,0,1,0,0,1,1],
[1,1,1,1,0,0,0,0,0,1,1,1,1,0,0,1,1,1,1,1,0,1,0,0,1],
[1,1,0,0,1,1,1,1,1,0,0,1,1,0,1,1,1,1,1,1,1,0,1,0,1],
[1,1,0,1,1,0,1,1,0,1,0,1,1,0,1,0,1,1,0,1,1,1,1,0,1],
[1,0,1,1,1,0,1,1,0,1,1,0,1,0,1,0,1,1,0,1,1,0,0,0,1],
[1,0,1,0,1,1,0,0,1,1,0,0,1,0,1,1,0,0,1,1,1,1,0,0,1],
[1,0,0,1,1,1,1,1,1,0,1,0,1,1,0,1,1,1,1,1,0,0,0,1,1],
[1,0,1,1,1,1,1,1,1,1,0,0,1,1,0,0,1,0,1,0,1,0,0,1,1],
[1,0,0,0,1,1,1,1,0,1,0,0,1,1,1,0,1,1,0,1,1,0,1,1,1],
[1,1,0,1,1,0,1,1,0,1,0,1,1,1,1,0,0,1,0,1,0,0,1,1,1],
[1,1,0,0,0,1,1,1,1,0,0,1,1,1,1,1,0,0,1,0,0,1,1,1,0],
[1,1,1,0,1,1,0,1,0,0,1,1,1,1,1,1,1,0,0,0,1,1,1,0,1],
[1,1,1,0,0,0,1,0,1,0,1,1,1,1,1,1,1,1,1,1,1,1,1,1,0],
[0,1,1,1,0,0,0,1,0,1,1,1,0,0,0,0,0,1,1,1,1,1,1,0,1],
[1,0,1,1,1,0,0,0,1,1,0,0,0,1,1,1,0,0,0,1,1,1,1,1,0],
[0,1,1,1,1,1,1,1,1,1,0,1,1,1,1,1,0,1,0,0,1,1,1,0,1],
[1,0,1,1,0,0,0,1,1,0,0,1,0,0,1,1,1,0,1,0,0,1,1,1,0],
[0,1,1,1,1,0,0,0,1,0,1,1,1,1,0,1,1,1,1,1,0,0,1,1,1],
[1,0,1,1,1,1,0,1,0,0,1,1,0,0,1,1,1,1,0,0,1,0,0,1,1],
[0,1,1,0,0,0,1,0,1,0,1,1,1,1,1,1,1,1,1,1,0,1,0,1,1],
[1,1,0,0,0,1,0,0,1,0,0,1,0,1,0,0,1,1,0,1,1,0,0,1,1],
[1,1,1,1,1,0,0,0,1,1,0,1,1,0,1,1,1,0,1,0,0,0,1,1,1],
],
"15710":[
[1,1,1,1,1,0,1,0,1,1,1,0,0,0,0,0,1,1,1,1,0,0,1,0,1,1,1,0,1,1],
[1,1,1,0,0,1,0,1,0,0,0,0,1,1,1,1,1,0,0,0,0,1,1,0,1,0,1,1,0,1],
[1,0,1,1,0,0,0,0,0,0,0,1,1,0,0,0,0,0,1,1,1,1,1,0,0,0,1,0,1,0],
[0,1,1,0,0,1,1,1,1,1,0,1,0,0,1,1,1,1,1,1,1,0,1,1,1,0,1,0,1,0],
[1,0,0,1,0,1,0,0,0,1,1,1,0,1,1,0,0,0,0,1,1,0,1,0,1,0,0,0,1,1],
[1,1,0,0,0,1,1,1,0,0,0,1,0,1,0,0,0,0,0,1,0,1,1,0,1,1,0,1,0,1],
[1,0,0,1,1,1,0,1,1,0,0,0,1,1,1,1,0,0,0,1,0,1,1,0,0,1,0,1,0,1],
[1,0,1,1,0,0,1,1,0,0,1,0,0,0,0,1,0,0,0,1,0,0,1,0,0,1,0,0,0,1],
[0,0,1,0,0,1,1,1,0,1,1,1,0,0,0,1,1,0,0,1,1,0,1,0,0,1,1,0,0,1],
[0,1,1,0,1,0,1,1,1,1,1,1,0,0,0,0,1,0,0,0,1,0,1,0,0,0,1,1,1,0],
[0,1,0,0,0,1,1,0,1,1,0,1,0,1,1,0,1,1,1,1,1,0,1,1,1,1,0,0,1,1],
[0,1,0,1,1,0,1,1,1,0,1,1,1,1,1,1,1,1,0,0,1,1,1,0,0,1,1,1,0,0],
[0,1,0,0,1,0,1,0,1,1,1,1,0,1,1,1,0,0,0,1,0,1,1,1,1,0,0,1,0,0],
[1,1,0,1,1,1,1,0,1,1,1,0,1,1,1,1,1,1,0,0,0,0,1,0,0,0,0,1,1,0],
[1,0,0,1,1,1,0,1,1,0,1,1,1,1,1,0,1,1,0,0,1,0,0,1,1,1,1,0,1,0],
[1,0,1,0,0,1,1,1,0,1,0,1,0,1,0,1,1,0,0,0,1,0,0,0,1,1,1,0,1,1],
[1,0,0,1,1,1,1,1,0,1,1,0,1,1,0,0,1,0,1,1,1,1,0,0,1,0,0,1,0,1],
[1,0,1,0,1,0,0,1,1,0,1,0,1,0,0,1,1,1,1,1,0,1,0,1,1,1,1,1,0,1],
[1,0,0,0,1,1,0,1,1,0,1,0,1,0,1,1,1,0,1,0,1,1,1,1,0,1,1,0,0,1],
[1,1,0,1,0,1,1,0,1,1,0,0,1,0,1,1,1,0,1,0,1,0,1,1,1,1,1,1,0,1],
[1,1,0,0,0,1,1,1,0,0,0,1,1,0,1,0,1,1,1,1,1,1,1,0,1,1,1,0,0,1],
[1,1,1,1,0,0,0,0,0,1,1,1,1,0,1,0,1,1,0,1,1,0,1,0,1,1,0,0,1,1],
[1,1,1,1,1,1,1,1,1,1,1,1,1,0,0,1,1,1,0,1,1,0,1,1,0,0,1,0,1,0],
[1,1,1,1,1,1,1,1,1,0,0,1,1,1,0,0,1,0,1,1,0,1,0,1,1,1,0,0,1,0],
[0,0,1,1,1,0,0,0,0,0,0,0,0,1,0,1,1,1,0,1,0,1,0,1,1,1,0,1,1,0],
[1,0,0,0,0,0,1,1,1,1,1,1,0,1,0,1,0,1,1,1,1,1,1,0,1,0,0,1,0,0],
[0,1,0,0,1,0,0,1,0,1,0,0,0,1,0,0,1,1,1,1,0,1,0,1,0,0,1,1,0,0],
[1,0,1,1,0,1,1,1,1,0,0,1,1,1,1,0,0,1,0,1,0,0,0,0,1,1,1,1,1,1],
[1,1,1,1,1,1,1,0,0,0,1,1,1,1,1,1,1,0,0,0,0,1,1,1,1,1,1,1,1,0],
[1,1,1,1,1,1,1,1,0,0,1,1,1,1,1,1,1,1,1,1,1,1,1,1,1,1,1,0,0,0],
],
"15711":[
[1,1,1,1,0,0,0,0,0,1,1,1,1,0,1,1,1,1,0,1,1,1,1,1,1,1,1,1,1,1],
[1,0,0,1,1,1,0,0,1,1,0,0,1,1,1,0,0,1,0,0,0,1,1,1,1,1,1,1,1,1],
[1,0,1,0,0,1,1,0,1,0,0,0,0,1,0,0,1,1,1,1,0,0,1,0,0,0,0,0,0,0],
[1,0,1,1,0,0,1,0,1,1,1,1,1,1,1,0,0,0,0,1,1,0,0,0,1,1,1,1,1,0],
[1,0,0,1,1,0,1,1,1,1,0,0,0,0,0,1,1,1,0,0,1,0,0,1,1,0,0,0,1,1],
[1,1,0,1,1,0,0,1,1,0,0,1,1,1,0,0,0,1,1,1,1,0,0,1,0,1,0,1,0,1],
[0,1,0,1,0,1,0,1,0,0,1,1,1,0,0,1,1,0,1,0,0,1,1,1,0,1,1,1,0,1],
[0,1,0,0,0,1,1,1,0,1,1,1,1,0,1,0,1,0,1,0,1,1,0,1,0,1,1,1,0,1],
[0,1,1,0,1,0,1,1,0,1,0,1,0,0,0,1,1,0,1,1,1,0,1,1,1,1,1,0,1,1],
[0,0,1,1,0,0,1,1,0,1,1,0,0,0,0,1,1,0,1,0,0,1,1,0,0,1,1,1,1,0],
[0,0,1,1,1,1,1,1,0,1,1,1,0,1,1,1,0,1,1,1,1,0,0,0,0,0,0,0,0,0],
[0,1,1,1,0,0,0,1,1,0,1,0,1,0,1,1,0,1,1,1,1,0,0,1,1,1,1,1,1,1],
[0,1,0,0,1,1,1,1,1,0,0,1,1,1,0,0,1,1,0,0,1,1,0,0,0,0,0,1,1,1],
[1,1,0,1,0,1,1,1,1,1,0,0,0,0,1,1,1,0,0,1,0,1,0,1,1,1,0,1,1,1],
[1,0,0,1,1,0,1,0,1,1,1,1,1,1,1,0,0,1,1,1,0,1,1,1,0,1,0,1,1,1],
[1,0,1,0,1,0,1,0,0,1,1,1,0,1,0,1,1,1,0,1,1,1,1,0,0,1,0,0,0,0],
[1,0,1,0,1,0,0,0,1,1,1,1,1,1,0,1,0,0,0,1,0,0,1,0,1,1,1,1,1,0],
[1,0,1,0,0,0,1,1,1,1,0,0,0,1,1,1,0,0,0,1,1,1,1,1,1,0,0,0,1,0],
[1,0,0,1,1,1,1,0,0,1,0,0,0,0,0,1,0,0,0,0,1,0,0,0,0,0,1,0,1,1],
[1,1,1,1,0,1,0,0,0,1,0,0,0,0,0,1,0,0,0,1,1,0,1,1,0,1,1,0,0,1],
[0,1,1,0,0,1,0,0,0,1,1,1,1,0,0,1,1,0,0,1,0,0,1,0,0,0,0,1,0,1],
[0,1,0,1,1,1,0,0,1,1,0,0,1,1,1,0,1,1,0,1,0,1,0,1,0,0,1,1,0,1],
[0,1,0,1,1,1,1,1,1,0,1,0,0,1,0,0,0,1,0,1,0,1,1,0,0,1,0,1,0,1],
[1,1,0,1,1,1,0,0,1,0,1,1,0,1,0,0,0,1,0,1,1,0,1,1,0,0,1,1,0,1],
[1,0,1,1,1,0,0,0,1,1,0,0,1,0,0,0,0,1,0,0,1,0,1,1,1,1,1,1,0,1],
[1,0,1,0,1,0,0,0,0,1,1,1,1,0,0,0,1,1,0,0,1,1,0,0,1,1,1,0,1,1],
[1,0,0,1,1,1,0,0,1,0,0,0,1,0,1,1,1,0,0,0,0,1,1,1,0,0,0,1,1,0],
[1,1,1,1,0,1,1,1,1,0,0,0,0,1,1,0,0,0,1,1,0,0,0,1,1,1,1,1,0,0],
[0,0,0,0,0,0,0,0,1,1,0,0,0,1,0,0,1,1,1,1,1,1,0,0,0,0,0,0,0,1],
[0,0,0,0,0,0,0,0,0,1,1,1,1,1,0,1,1,1,1,1,1,1,1,1,1,1,1,1,1,1],
],
"15712":[
[1,1,1,1,1,1,1,1,1,0,0,0,0,0,0,1,1,1,1,1,0,1,1,1,1,1,1,1,1,1],
[1,1,1,0,1,0,0,0,0,0,0,0,0,0,0,1,0,0,0,1,0,0,0,1,0,0,0,1,1,1],
[1,0,0,1,0,1,0,0,1,1,1,1,1,1,0,1,0,1,1,0,0,0,1,0,0,1,1,1,0,1],
[1,1,0,1,0,0,0,0,1,0,0,0,0,1,1,0,0,1,1,0,0,0,0,0,0,0,0,1,0,1],
[1,0,0,0,0,0,0,0,1,1,1,0,0,0,0,0,1,0,1,1,1,1,1,0,1,1,0,0,1,0],
[0,0,0,0,0,0,1,1,1,0,0,1,1,1,0,1,1,1,0,0,0,0,1,1,0,1,0,0,0,1],
[0,1,1,1,1,0,1,0,0,1,1,1,1,1,1,0,1,1,0,1,1,1,0,0,0,1,0,0,1,1],
[1,1,1,1,1,1,0,1,0,0,0,0,0,1,0,1,1,0,1,0,1,1,1,0,1,1,0,0,1,1],
[1,1,0,0,1,1,0,1,1,0,0,1,1,0,1,1,1,0,1,1,0,0,0,0,1,0,0,1,0,1],
[1,1,0,1,1,0,0,1,0,1,1,0,1,1,0,1,0,1,1,1,1,1,1,1,1,0,0,0,1,0],
[1,1,0,0,0,0,1,1,0,1,1,0,1,1,1,0,0,1,1,1,0,1,1,1,0,0,1,1,0,1],
[1,1,0,0,0,0,1,0,0,0,1,1,0,1,1,0,1,1,1,1,0,1,1,0,1,0,0,0,1,1],
[1,1,0,0,0,0,1,0,0,1,0,1,1,1,1,1,1,1,1,1,1,1,0,0,1,0,0,0,0,0],
[0,1,1,0,0,0,1,0,1,0,1,1,1,0,1,1,1,0,1,1,1,0,1,0,1,1,1,1,0,0],
[0,1,1,1,1,1,1,0,0,1,1,1,1,0,1,1,1,0,1,1,1,1,0,0,1,1,1,1,1,0],
[1,0,0,1,1,1,1,0,1,0,0,1,1,1,0,0,0,1,1,0,1,1,1,0,1,0,0,1,1,1],
[0,1,0,0,0,0,1,0,0,1,1,1,1,1,1,1,1,1,1,0,1,0,0,0,1,0,0,0,1,1],
[1,0,0,0,0,0,1,1,0,0,1,1,0,1,1,1,1,0,1,1,1,1,0,1,1,0,0,0,1,1],
[1,0,1,0,0,0,0,1,0,1,0,1,0,1,1,0,1,0,1,1,0,0,0,1,0,0,0,0,0,1],
[1,0,1,0,0,0,0,1,0,0,1,1,1,1,1,0,1,1,1,1,1,0,0,1,0,0,0,0,0,1],
[1,1,0,1,1,0,0,1,1,0,1,0,1,0,1,1,1,1,0,1,0,0,1,1,0,1,1,0,1,1],
[1,1,0,0,0,0,0,0,1,0,0,1,1,0,1,1,1,0,1,0,1,0,1,0,1,1,0,0,1,1],
[1,1,0,1,0,1,0,0,1,1,0,0,0,1,0,1,1,1,0,0,0,1,1,0,1,1,1,1,1,1],
[1,1,1,0,1,0,1,0,0,1,1,1,0,0,0,0,0,0,0,1,1,1,0,0,0,1,1,1,1,0],
[1,1,1,1,1,1,0,0,0,0,1,1,1,1,0,0,0,1,1,1,1,0,0,0,0,0,0,0,0,0],
[1,1,1,1,1,1,1,1,0,0,1,1,0,1,1,1,1,1,0,1,1,0,1,1,1,1,1,1,1,1],
[0,0,0,0,0,0,0,0,0,1,1,1,0,0,0,0,0,0,0,1,1,0,0,0,0,0,0,1,1,1],
[1,1,1,1,0,1,0,0,0,1,1,0,0,0,1,1,1,1,1,0,1,1,0,0,0,1,1,0,0,1],
[1,1,0,0,1,0,0,1,1,1,1,0,0,0,0,0,1,1,0,0,1,1,1,1,0,0,0,0,1,0],
[0,0,1,0,0,0,0,0,0,0,0,0,1,1,1,1,0,0,1,0,1,1,1,1,1,0,0,1,0,1],
],
}