{"23501":[
[0,0,1,1,1,0,0,0,1,0,1,0,1,0,0,0,0,0,1,0,0,0,0,0,0],
[0,0,1,0,1,0,0,0,1,1,0,1,1,0,0,1,0,1,0,1,0,0,1,1,1],
[1,1,1,0,1,1,1,0,0,1,1,1,0,0,1,0,1,0,1,0,0,1,1,0,1],
[1,0,0,1,0,0,1,0,0,0,0,0,1,1,1,1,1,1,1,0,0,1,0,1,0],
[1,1,1,0,1,1,1,0,0,1,1,1,1,1,1,1,1,1,1,1,0,1,1,0,1],
[0,0,1,0,1,0,0,0,1,1,0,0,0,1,1,1,1,0,0,0,1,0,1,1,1],
[0,0,1,1,1,0,1,1,1,1,0,1,1,0,0,0,0,1,1,0,1,0,0,0,0],
[0,1,0,0,0,1,1,1,1,0,1,0,0,0,0,0,0,0,0,1,0,0,0,1,0],
[1,0,1,0,1,1,1,0,0,1,1,0,0,0,1,0,0,1,0,1,0,0,1,0,1],
[0,1,0,1,1,1,0,0,0,0,1,0,0,0,0,0,1,0,0,1,1,1,1,1,1],
[1,1,1,1,1,1,0,0,1,0,1,0,0,0,0,1,1,1,0,1,1,1,1,1,1],
[1,1,1,1,1,1,1,0,1,1,1,1,0,0,0,0,0,0,1,0,0,0,1,1,1],
[1,1,0,0,1,1,1,0,0,1,1,1,1,1,1,1,1,1,1,1,1,0,0,1,1],
[1,1,0,1,0,0,0,1,0,0,1,0,1,1,1,1,1,1,0,1,1,1,0,1,1],
[1,1,0,1,1,0,0,0,0,0,0,0,0,1,1,1,1,0,1,0,0,0,1,1,0],
[1,1,1,1,1,1,1,1,1,0,0,0,1,0,1,1,1,0,1,1,1,1,1,0,0],
[1,1,1,0,0,1,1,1,0,0,0,1,0,1,1,1,0,0,1,1,1,1,0,0,0],
[1,1,1,0,0,0,0,0,0,1,1,1,1,1,1,0,0,1,1,1,0,1,1,1,0],
[1,1,1,0,0,0,1,1,1,1,1,1,0,0,0,0,1,1,1,1,1,1,0,1,1],
[1,1,1,1,0,0,0,0,0,0,0,0,0,1,1,1,1,1,1,0,1,0,1,0,1],
[1,1,1,1,1,1,1,1,1,1,1,1,1,1,1,1,1,1,1,0,1,1,0,1,1],
[1,1,1,1,1,1,1,1,1,1,1,1,1,1,0,1,1,0,1,1,0,1,1,1,0],
[0,1,0,0,0,0,1,0,0,0,0,1,0,0,0,1,0,1,0,1,0,0,0,0,0],
[1,0,1,0,0,1,0,1,0,0,1,0,1,0,0,1,1,0,1,1,0,0,0,0,0],
[0,1,0,0,0,0,1,0,0,0,0,1,0,0,0,0,1,1,1,0,0,0,0,0,0],
],
"23502":[
[1,1,0,1,1,1,0,0,0,1,1,1,1,1,0,0,1,1,1,0,1,1,1,0,1],
[1,0,0,0,1,1,0,0,0,1,1,1,1,1,0,0,0,1,0,0,1,1,0,1,0],
[1,0,0,0,1,0,0,0,1,1,0,0,1,1,1,0,1,1,0,1,1,1,1,0,1],
[0,1,0,0,1,0,0,1,0,0,0,0,1,1,1,1,0,0,1,0,0,1,1,1,0],
[0,0,1,0,1,1,1,0,0,0,0,1,1,0,0,1,0,0,1,0,0,0,1,0,1],
[0,0,1,1,0,1,0,0,0,0,1,1,0,0,0,0,1,1,0,1,1,1,1,1,0],
[1,1,1,0,1,0,1,1,1,1,1,1,1,1,1,1,0,1,0,0,1,1,0,1,1],
[0,0,1,1,0,1,1,0,0,0,0,1,1,1,1,0,0,0,1,0,1,0,1,0,1],
[0,0,1,1,1,1,0,0,0,0,0,0,1,1,1,0,0,1,1,1,0,1,0,1,1],
[0,1,1,0,1,0,1,0,0,0,1,1,1,1,1,1,1,1,1,1,0,1,1,1,1],
[1,1,0,0,1,0,0,1,1,1,1,0,0,0,0,1,1,1,0,0,1,0,0,1,1],
[1,0,0,0,1,0,0,0,1,1,0,0,0,0,0,0,1,1,1,1,0,1,1,1,1],
[1,0,0,0,1,1,0,0,0,1,0,0,1,1,0,0,1,1,1,1,0,1,1,1,1],
[1,0,0,1,0,1,0,0,0,1,0,0,0,0,0,0,0,0,1,1,1,1,1,0,1],
[1,1,1,1,0,1,1,1,1,1,0,0,0,0,0,0,1,1,0,0,1,1,0,1,0],
[1,0,1,1,0,1,1,1,0,0,1,0,0,0,0,1,0,1,1,0,1,1,1,0,1],
[0,1,0,1,0,1,1,1,0,0,1,0,0,0,0,1,1,0,1,0,0,1,1,1,1],
[1,0,1,1,0,1,0,1,1,0,0,0,0,0,0,0,1,0,0,0,0,1,1,1,1],
[1,1,0,1,1,0,1,0,1,0,0,0,0,0,1,0,0,1,0,0,1,1,0,1,1],
[1,0,1,0,1,0,0,1,1,0,1,0,0,0,1,1,0,0,1,1,1,0,1,0,1],
[1,1,0,1,1,0,1,1,1,0,1,1,1,0,0,1,1,0,1,1,1,1,0,1,1],
[1,1,1,1,1,1,1,1,1,0,0,1,1,1,1,1,1,0,0,0,1,1,1,1,1],
[0,0,0,1,0,1,0,1,1,1,0,0,1,1,1,1,0,0,0,0,1,1,1,0,1],
[1,1,0,0,1,0,1,1,0,0,0,0,0,0,0,0,0,1,0,0,1,1,0,1,0],
[1,1,1,1,0,1,0,1,1,1,1,1,1,1,1,1,1,1,1,1,1,1,1,0,1],
],
"23503":[
[0,0,0,0,0,0,0,0,0,0,0,0,0,1,1,1,1,1,1,1,0,0,0,0,0],
[0,0,0,0,0,0,0,0,0,1,1,1,1,1,0,0,0,0,0,1,1,1,1,0,0],
[0,0,0,0,0,0,0,1,1,1,0,0,0,1,1,1,0,0,1,1,1,0,1,1,1],
[0,0,0,0,0,0,1,1,0,0,1,1,1,0,1,1,1,1,1,0,1,1,0,0,1],
[0,0,0,0,0,0,1,0,0,1,1,1,0,1,1,0,1,0,1,0,0,1,0,0,0],
[0,0,0,1,0,0,1,1,1,1,0,0,1,1,0,1,1,0,1,1,0,1,1,0,1],
[0,0,1,1,1,0,0,0,1,1,0,1,1,1,0,1,1,0,1,1,0,0,1,1,1],
[0,1,1,1,1,1,0,0,0,1,0,0,1,0,0,1,0,0,1,1,0,0,1,0,0],
[0,0,1,1,1,0,0,0,0,1,1,1,1,0,1,1,1,0,0,1,1,1,1,0,0],
[1,0,0,1,0,0,0,0,0,0,0,1,1,1,1,0,1,1,1,1,0,1,1,0,0],
[1,1,0,0,0,0,0,0,0,0,0,0,0,0,0,0,0,0,0,1,0,1,1,0,0],
[1,1,1,0,1,1,1,0,0,0,0,1,1,1,0,0,0,0,0,1,1,0,1,1,0],
[1,1,0,1,0,0,0,1,0,0,1,0,0,0,1,0,0,0,0,1,1,0,1,1,0],
[1,0,0,1,0,1,0,1,1,1,1,0,1,0,1,0,0,0,0,0,1,0,0,1,0],
[0,0,0,1,0,1,1,0,0,0,0,1,1,0,1,0,0,1,0,0,1,1,0,1,0],
[0,0,0,1,1,0,0,0,0,0,0,0,0,1,1,0,1,1,1,0,0,1,0,1,0],
[0,0,0,0,1,0,0,0,0,0,0,0,0,1,0,1,1,1,1,1,0,1,0,1,0],
[0,0,0,1,0,0,0,1,0,0,1,0,0,0,1,0,1,1,1,0,0,1,0,1,0],
[1,0,0,1,0,0,0,1,0,0,1,0,0,0,1,0,0,1,0,1,1,1,0,1,1],
[1,1,0,1,1,1,0,0,0,0,0,0,1,1,1,0,0,0,1,1,1,1,0,1,1],
[1,1,1,0,0,1,1,1,1,1,1,1,1,0,0,1,0,1,1,1,1,1,0,1,1],
[1,0,1,0,0,0,1,0,0,1,1,1,0,0,0,1,1,1,1,0,1,0,0,1,0],
[1,1,1,0,0,0,1,0,0,0,0,1,0,0,0,1,1,1,1,0,0,0,1,0,0],
[0,1,1,1,1,1,1,1,1,1,1,1,1,1,1,1,1,0,0,1,1,0,0,0,1],
[1,1,0,1,1,1,1,1,1,1,1,1,1,1,1,1,1,1,1,1,0,1,1,1,1],
],
"23504":[
[0,1,0,0,1,1,1,0,0,0,1,1,1,0,1,0,1,0,1,1,1,0,0,0,0,0,1,1,0,1],
[0,1,0,0,0,1,0,0,0,1,1,1,0,1,0,1,0,1,1,0,1,1,0,0,0,1,1,0,1,0],
[1,1,1,0,0,1,0,0,1,1,1,1,1,0,1,1,1,1,0,1,0,1,1,1,1,0,1,1,0,1],
[0,0,1,1,1,1,1,0,1,0,0,0,1,1,1,1,0,1,1,0,1,1,1,0,0,0,1,1,1,1],
[0,0,0,1,1,0,1,1,0,0,0,0,0,0,1,0,1,0,1,1,1,1,0,0,0,1,0,0,1,0],
[0,1,1,1,0,1,0,1,1,1,1,0,0,0,1,1,0,1,1,1,1,1,0,0,0,1,0,0,1,0],
[1,0,0,1,1,0,1,1,0,0,1,1,1,1,1,1,1,1,1,0,0,1,1,1,1,0,0,1,1,0],
[0,0,0,1,1,1,0,1,1,0,0,0,1,1,1,1,1,1,1,0,0,0,1,1,0,0,0,1,0,0],
[0,0,1,1,0,1,0,0,1,1,0,1,0,0,0,1,1,1,1,1,0,0,1,1,0,0,1,1,0,0],
[0,0,1,0,0,1,0,0,1,1,1,1,0,1,1,0,1,1,1,1,0,0,1,1,1,1,1,1,1,0],
[1,1,1,0,0,1,1,0,0,1,1,0,0,1,1,0,0,1,1,1,0,1,1,1,0,0,1,1,1,1],
[1,1,0,0,1,1,1,0,0,0,1,0,0,0,0,0,0,0,0,0,1,1,0,0,0,0,0,0,1,1],
[1,1,0,0,1,1,1,0,0,1,1,1,0,0,0,0,1,0,0,0,0,0,1,0,0,0,0,0,1,1],
[1,1,1,1,0,1,1,1,1,0,1,1,0,0,0,0,1,0,0,1,1,0,1,1,1,0,0,1,1,1],
[1,0,1,0,0,1,1,1,0,0,0,1,1,0,0,0,0,0,0,1,1,0,1,1,1,1,1,1,1,1],
[0,0,1,0,0,0,1,0,0,0,1,1,1,1,0,0,0,1,1,1,0,1,1,1,1,1,1,1,0,1],
[0,0,0,1,0,0,1,0,1,1,0,0,1,1,1,0,0,1,1,1,0,1,1,1,1,0,1,0,1,0],
[0,0,0,1,1,0,1,1,1,0,0,0,0,1,1,0,0,0,0,1,0,1,1,1,0,1,0,1,0,1],
[1,1,0,0,1,1,0,1,0,0,1,1,1,1,0,0,0,0,0,0,0,0,1,1,1,0,1,1,0,1],
[1,1,1,1,1,0,1,0,1,1,1,1,1,0,0,0,0,0,0,0,0,0,1,1,1,0,1,1,1,1],
[1,0,0,0,0,1,0,1,0,0,0,1,1,0,0,0,1,0,0,0,1,0,0,1,1,0,1,0,1,1],
[0,0,0,1,1,1,1,1,1,0,1,1,0,0,0,0,1,1,0,0,1,1,0,0,1,0,1,0,0,1],
[0,0,1,1,0,0,1,0,1,1,1,1,0,1,0,1,1,1,1,1,1,1,1,0,1,1,1,0,0,1],
[1,1,1,0,0,0,1,0,0,1,1,0,0,1,0,1,1,1,0,0,0,0,0,0,0,1,0,0,0,1],
[0,1,0,0,0,1,1,0,0,1,1,0,1,1,0,1,1,0,0,0,0,1,0,1,0,0,1,0,1,1],
[0,1,0,0,0,1,1,0,1,0,1,0,1,1,0,1,1,0,0,1,1,0,1,1,1,0,1,0,1,1],
[0,1,1,1,1,0,1,0,1,0,1,0,1,0,1,1,1,0,0,0,1,1,1,1,1,0,1,1,1,1],
[0,1,1,1,1,0,1,0,0,1,0,0,0,0,1,0,0,0,1,1,1,1,1,0,0,1,1,1,1,1],
[1,0,1,1,1,0,1,1,1,1,0,0,0,0,1,0,0,0,0,0,0,0,0,1,1,1,1,1,1,1],
[1,1,1,1,1,1,1,1,1,1,1,1,1,1,1,1,1,1,1,1,1,1,1,1,1,1,1,1,1,1],
],
"23505":[
[0,0,0,0,0,0,0,0,0,0,0,0,0,0,0,0,0,0,0,0,0,0,0,1,0,1,0,1,0,0],
[0,0,0,0,0,0,0,0,0,0,0,0,0,0,0,0,0,0,1,1,1,0,1,1,1,0,1,1,1,0],
[0,0,0,0,0,0,0,0,0,0,0,0,0,0,0,0,0,1,1,0,1,1,1,0,1,1,1,0,1,1],
[0,0,0,0,0,0,0,0,0,0,0,0,0,0,0,0,0,1,0,1,0,1,0,1,0,1,0,1,0,1],
[0,0,0,0,0,0,0,0,0,0,0,0,0,0,0,0,1,1,1,0,1,1,1,0,1,1,1,0,1,1],
[0,0,0,0,0,0,0,0,0,0,0,0,0,0,0,1,1,0,1,1,1,0,1,1,1,0,1,1,1,0],
[0,0,0,0,0,0,0,0,0,0,0,0,0,0,0,1,0,1,0,1,0,1,0,1,0,1,0,1,0,1],
[0,0,0,0,0,0,0,0,0,0,0,0,0,0,0,1,1,0,1,1,1,0,1,1,1,0,1,1,1,0],
[0,0,0,0,0,0,0,0,0,0,0,0,0,0,0,0,1,1,1,0,1,1,1,0,1,1,1,0,1,1],
[0,0,0,0,1,1,1,0,0,0,0,0,1,1,1,0,0,1,0,1,0,1,0,1,0,1,0,1,0,1],
[0,0,0,1,0,0,0,1,1,1,1,1,0,0,0,1,0,1,1,0,1,1,1,0,1,1,1,0,1,1],
[0,0,0,1,0,1,1,0,0,0,0,0,1,1,0,1,0,0,1,1,1,1,1,1,1,0,1,1,1,0],
[0,0,0,0,1,0,0,1,1,0,1,1,0,0,1,0,0,0,0,1,0,1,0,1,0,1,0,1,0,0],
[0,0,0,0,1,0,0,0,0,0,0,0,0,0,1,0,0,0,1,0,1,1,0,1,1,0,1,1,0,0],
[0,0,0,1,0,0,0,1,0,0,0,1,0,0,0,1,0,0,1,0,1,0,1,0,1,1,1,0,0,0],
[0,0,0,1,0,0,0,0,0,0,1,0,0,0,0,1,0,1,1,1,1,1,1,0,1,0,0,0,0,0],
[0,0,0,1,0,0,0,0,0,1,1,1,0,0,0,1,1,1,0,0,1,1,0,1,0,0,0,0,0,0],
[0,0,0,1,1,0,0,0,0,0,0,0,0,0,1,1,0,0,0,1,0,1,1,0,0,0,1,1,1,0],
[0,1,1,1,1,1,1,1,1,1,1,1,1,1,1,0,0,1,1,1,0,1,0,0,0,1,1,0,1,1],
[1,1,0,0,0,1,1,1,1,1,1,0,1,1,0,1,1,1,1,0,0,1,1,1,0,1,0,1,0,1],
[1,0,1,0,1,1,1,1,1,0,0,1,0,1,0,0,0,0,0,1,1,1,1,1,1,1,1,0,1,1],
[1,0,1,1,0,0,0,1,1,1,1,0,0,0,0,0,1,1,1,1,1,1,1,1,0,1,1,1,1,1],
[1,0,1,1,1,0,0,1,1,1,0,1,0,0,0,1,1,1,1,0,0,0,1,0,1,0,1,1,1,0],
[0,1,0,0,0,0,0,1,1,1,1,1,1,1,1,1,1,0,0,0,0,0,1,1,0,1,1,1,0,0],
[0,0,1,1,1,1,1,0,0,1,0,0,0,0,0,1,0,0,0,0,0,0,0,1,1,1,0,1,0,0],
[1,1,1,1,0,1,1,1,0,1,0,1,1,1,0,1,1,1,1,1,1,1,1,0,1,0,0,1,0,1],
[0,1,1,1,0,1,1,0,0,1,0,0,1,1,0,1,1,0,0,0,0,0,0,0,1,0,1,0,1,0],
[1,0,1,1,0,1,1,1,0,1,0,1,0,1,0,1,1,1,1,1,0,0,1,0,1,1,0,1,1,1],
[0,1,1,1,0,0,0,0,0,1,0,0,0,0,0,1,1,0,1,1,1,0,1,1,1,0,1,0,1,1],
[1,1,1,1,1,1,1,1,1,1,1,1,1,1,1,1,1,1,1,1,1,1,1,1,1,1,1,1,1,1],
],
"23506":[
[0,0,0,0,1,1,1,1,1,1,1,0,0,0,1,1,0,0,1,1,0,0,1,1,1,0,0,1,1,0],
[0,0,1,1,0,1,1,0,1,1,0,0,1,1,0,1,0,0,0,1,1,0,0,1,0,0,1,1,0,0],
[1,1,1,1,1,1,0,1,0,1,1,1,1,1,0,1,0,0,1,1,1,1,1,1,0,1,1,1,0,0],
[1,1,0,0,1,1,1,0,1,1,1,0,0,1,1,1,0,1,1,0,1,1,0,0,1,1,1,1,1,0],
[1,0,0,1,1,0,1,1,1,0,1,1,0,0,1,0,0,1,0,0,0,1,1,0,1,0,0,0,1,1],
[0,0,1,1,0,0,0,1,0,0,0,1,1,0,1,1,0,0,1,1,1,1,1,1,0,1,1,0,0,1],
[0,0,1,1,0,0,0,1,1,0,0,1,1,0,0,1,0,1,1,0,1,0,0,1,0,0,1,1,0,1],
[0,1,1,0,0,1,0,1,1,1,0,0,1,0,0,1,0,1,0,1,0,0,0,1,1,0,0,1,1,1],
[1,1,1,0,0,1,1,1,1,0,1,0,1,1,1,1,1,1,0,1,0,0,1,1,1,0,0,1,1,0],
[0,1,1,0,1,1,1,0,1,1,1,0,1,0,1,1,1,0,0,1,1,1,1,1,1,0,1,1,0,0],
[0,0,1,1,1,1,0,0,0,1,1,1,1,0,0,1,1,0,1,1,1,1,0,0,1,1,1,0,0,0],
[0,0,0,0,0,0,0,0,0,0,0,1,1,1,0,1,1,0,1,1,0,0,0,0,0,0,0,0,0,0],
[0,0,0,0,0,0,0,0,0,1,1,1,1,1,0,1,1,1,1,1,1,0,0,0,0,0,0,0,0,0],
[0,0,0,0,0,0,0,0,1,1,0,0,0,1,1,1,1,0,0,0,1,1,0,0,0,0,0,0,0,0],
[0,0,0,0,0,1,1,1,1,1,0,1,1,0,0,0,0,1,1,0,1,1,1,1,1,0,0,0,0,0],
[0,0,0,1,1,1,0,0,1,1,1,0,0,0,0,0,0,0,0,1,1,1,0,0,1,1,1,0,0,0],
[0,0,1,1,0,0,1,1,1,1,1,0,0,1,0,0,1,0,0,1,1,1,1,1,0,0,1,1,0,0],
[0,0,1,0,0,1,1,0,0,1,1,0,0,0,0,1,0,0,0,1,1,0,0,1,1,1,0,1,0,0],
[0,0,1,0,1,1,0,1,1,1,1,0,0,0,1,1,1,0,0,1,1,1,1,0,0,1,0,1,0,0],
[0,0,1,0,1,0,1,1,1,1,0,1,0,0,0,0,0,0,1,0,1,1,1,1,1,1,0,1,0,0],
[0,0,1,0,0,1,1,1,1,0,0,1,1,1,1,1,1,1,1,0,0,1,1,1,1,0,0,1,0,0],
[0,0,1,0,0,0,0,1,1,0,0,0,1,1,1,0,0,1,0,0,0,1,1,0,0,0,0,1,0,0],
[0,0,1,0,1,0,0,0,1,0,0,0,1,1,1,1,1,1,0,0,0,1,0,0,1,1,0,1,0,0],
[0,0,1,0,1,1,1,1,1,0,0,0,1,0,0,0,0,1,0,0,0,1,1,1,1,0,0,1,0,0],
[0,0,1,1,0,1,1,1,1,1,1,1,1,1,0,1,1,1,1,1,1,1,1,1,1,1,1,1,0,0],
[0,0,1,1,1,0,0,0,1,1,1,1,1,0,1,0,0,1,1,1,1,0,0,0,0,1,0,1,0,0],
[0,0,1,0,1,1,1,1,0,0,0,0,0,0,0,0,0,0,0,0,0,0,1,1,1,1,0,1,0,0],
[0,0,1,1,0,1,1,1,1,1,1,1,1,1,1,1,1,1,1,1,1,1,1,1,1,0,1,1,0,0],
[0,0,0,1,0,1,1,1,1,1,0,1,0,0,1,0,1,1,1,1,1,1,1,1,0,0,1,0,0,0],
[0,0,0,1,0,0,1,1,1,0,1,0,1,0,0,1,0,0,0,0,1,1,1,1,1,0,1,0,0,0],
],
"23507":[
[1,1,1,1,1,1,0,0,0,0,0,1,1,1,1,1,0,1,1,1,1,0,0,1,1],
[1,1,1,0,0,0,0,0,0,0,0,0,0,1,1,1,0,1,1,1,0,0,0,0,1],
[1,0,0,0,1,1,0,0,0,0,1,1,0,0,1,1,0,1,1,0,0,1,0,0,1],
[1,1,0,1,0,0,1,0,0,1,0,0,1,0,1,1,0,1,1,0,1,0,0,1,0],
[1,0,0,1,0,1,1,1,1,1,1,0,1,0,1,1,0,1,0,0,1,0,1,1,0],
[1,0,0,0,1,1,0,0,0,0,1,1,0,0,0,1,0,1,0,1,0,1,1,1,1],
[1,0,0,1,0,0,0,0,1,1,0,0,1,0,0,1,0,1,0,1,1,1,1,1,1],
[0,0,0,1,0,0,0,0,0,0,0,1,1,0,0,1,0,1,1,1,1,1,1,1,0],
[0,0,0,1,0,0,1,0,0,1,0,1,1,0,0,1,0,1,1,1,1,0,0,0,0],
[0,0,0,1,0,0,1,0,0,1,0,1,1,0,1,1,0,0,1,0,0,0,0,0,1],
[1,0,1,1,1,0,0,0,0,0,1,1,0,0,1,1,1,1,1,0,0,1,1,1,1],
[1,1,0,1,0,1,1,1,1,1,1,0,1,0,0,1,1,1,1,0,0,0,0,1,1],
[1,0,1,1,0,0,1,0,1,1,0,0,1,0,0,0,1,1,1,1,1,1,0,0,0],
[1,1,1,0,0,0,0,1,0,1,1,0,0,1,0,1,0,1,0,0,1,1,1,1,1],
[1,1,1,0,0,1,1,0,1,1,1,0,0,1,0,0,1,1,0,1,0,1,1,1,1],
[1,1,1,0,0,0,0,1,1,0,0,0,0,1,1,1,1,1,0,0,0,0,0,0,1],
[1,1,1,0,0,0,0,1,1,0,0,0,0,1,1,1,1,0,1,1,1,1,0,0,0],
[0,0,0,1,1,0,0,1,1,0,0,1,1,0,0,0,1,0,1,1,0,1,1,1,1],
[0,0,0,1,1,1,1,0,0,1,1,0,1,0,0,0,1,0,0,0,1,0,1,1,1],
[0,1,1,1,0,0,0,1,1,1,0,0,1,1,1,0,0,1,1,0,0,0,0,0,1],
[1,0,0,1,0,0,1,0,1,1,1,0,1,0,0,1,0,1,1,1,1,1,0,0,0],
[1,0,0,0,0,1,1,1,1,1,1,1,0,0,0,1,0,0,0,1,1,1,1,1,1],
[1,1,0,0,0,1,0,0,0,0,1,0,0,0,1,1,1,0,0,0,1,0,1,1,1],
[0,1,1,1,0,0,1,1,1,0,0,0,1,1,1,1,0,0,0,1,0,1,1,1,1],
[0,0,1,1,1,1,1,1,1,1,1,1,1,1,0,0,1,1,0,0,1,0,0,0,1],
],
"23508":[
[0,0,0,0,0,0,0,0,0,0,1,1,0,0,0,0,0,0,0,0,0,0,0,0,0],
[1,1,1,1,1,1,1,1,1,0,0,0,1,1,1,1,1,1,1,1,1,1,1,1,1],
[1,0,1,1,1,1,1,1,1,1,0,1,1,1,1,1,1,1,1,1,1,0,1,0,1],
[0,0,1,0,1,1,1,0,1,1,0,1,1,0,0,1,1,0,1,1,0,1,1,0,1],
[0,0,0,0,1,1,0,0,1,1,0,1,1,0,1,1,0,1,1,0,0,1,0,1,1],
[0,1,0,1,1,0,0,1,1,1,0,1,0,0,0,0,0,1,0,0,0,0,0,1,1],
[0,1,0,1,0,0,0,1,0,1,0,1,0,0,0,1,0,0,0,1,0,0,1,1,0],
[1,1,0,0,0,0,1,0,0,1,0,1,0,1,1,1,0,0,1,0,0,0,1,1,0],
[1,1,0,0,1,0,1,0,1,1,0,1,1,1,1,0,0,1,1,0,0,1,1,0,0],
[1,0,0,1,1,0,0,0,1,1,0,1,1,1,0,0,1,1,0,0,0,1,0,0,0],
[0,0,1,1,1,0,0,1,1,1,1,1,1,1,0,1,1,0,0,0,1,0,0,1,0],
[0,1,1,0,0,1,0,1,1,0,0,1,1,0,1,1,1,1,1,1,1,0,1,1,0],
[0,1,0,0,0,1,1,1,1,0,0,0,1,1,1,0,0,0,0,0,1,1,1,1,0],
[1,1,0,1,1,0,0,0,0,1,1,0,1,1,1,0,1,1,0,0,0,1,1,0,0],
[1,1,1,0,0,1,0,0,0,0,0,1,1,1,1,1,1,1,1,0,0,1,1,0,0],
[1,1,1,0,1,0,0,0,0,1,0,1,1,1,0,0,1,1,0,1,0,1,0,0,1],
[1,1,0,1,1,0,1,0,0,1,0,0,1,0,0,1,0,1,1,0,0,1,1,0,1],
[1,1,0,1,1,1,0,1,0,0,0,0,1,0,1,1,0,1,1,0,0,1,1,0,1],
[1,1,0,0,1,1,1,1,1,0,0,0,1,0,1,1,0,1,0,0,1,1,0,1,1],
[1,1,1,0,0,0,1,1,0,0,0,1,0,0,1,0,1,1,1,1,1,1,0,1,1],
[1,1,0,1,1,0,0,0,0,1,1,1,0,1,0,0,1,1,1,1,0,0,0,0,1],
[1,0,0,1,1,1,1,1,1,1,1,0,0,0,0,1,1,1,1,1,1,1,1,1,1],
[1,0,1,0,1,1,1,1,1,0,0,0,0,0,1,1,0,0,0,0,0,0,0,0,0],
[1,0,0,1,1,1,1,1,0,1,0,0,0,0,1,1,1,1,1,1,1,1,1,1,1],
[1,0,1,0,0,1,1,1,1,0,1,1,0,0,1,1,1,1,1,1,1,0,0,0,0],
],
"23509":[
[0,0,0,0,0,1,1,0,0,0,0,1,1,1,0,0,0,0,1,1,1,0,1,1,1],
[0,0,0,0,1,0,0,1,0,0,1,0,0,1,1,0,0,1,0,0,0,1,0,0,0],
[0,0,0,1,0,1,0,1,1,1,1,0,1,0,1,0,0,1,0,0,1,1,0,0,1],
[0,0,0,1,0,1,1,0,0,0,0,1,1,0,1,0,0,1,0,1,1,1,0,1,1],
[0,0,0,0,1,1,0,0,0,0,0,0,0,1,1,0,1,1,1,1,1,1,1,1,1],
[0,0,0,0,1,0,1,1,0,0,1,1,0,1,0,0,1,0,0,0,0,0,0,0,1],
[0,0,0,1,1,0,0,0,0,0,0,0,0,0,1,0,1,1,1,1,1,1,1,1,1],
[0,0,0,1,1,1,0,1,0,0,1,0,0,0,1,0,0,1,0,1,1,1,1,1,0],
[0,0,0,1,1,1,0,0,0,1,0,0,0,0,1,0,0,0,1,0,1,1,1,0,0],
[0,0,0,0,1,0,0,0,1,1,1,0,0,1,1,1,0,1,1,1,1,1,0,0,1],
[0,0,1,1,0,1,1,0,0,0,0,1,1,0,1,1,1,0,1,1,0,0,0,0,1],
[0,1,0,0,1,1,1,1,1,1,1,1,0,0,0,0,1,1,1,1,0,0,1,1,1],
[0,1,0,1,1,1,1,1,1,0,0,0,0,1,1,0,0,1,1,1,1,0,0,1,1],
[1,0,0,0,1,0,1,1,1,0,0,0,0,0,0,1,1,1,1,0,1,1,1,0,0],
[1,0,1,0,0,1,1,1,0,1,0,0,1,0,1,1,1,0,0,1,1,0,1,1,1],
[1,0,1,0,1,1,1,1,1,0,1,1,1,0,1,1,1,0,1,1,1,0,1,1,1],
[1,0,1,1,0,1,1,1,1,1,1,1,1,0,0,1,0,0,0,1,0,0,1,1,1],
[1,0,1,1,0,0,0,1,0,0,0,1,0,0,1,1,0,1,0,1,0,1,1,0,0],
[1,1,0,1,1,0,0,1,0,1,1,1,0,0,1,1,0,1,0,0,0,1,1,1,0],
[1,1,1,0,0,0,1,1,1,1,1,1,1,1,1,0,1,0,0,0,1,1,0,1,0],
[1,0,1,1,1,1,1,0,0,0,0,0,1,1,1,0,1,0,1,0,1,1,1,1,0],
[0,1,0,1,1,1,0,0,1,1,0,0,0,1,0,1,1,0,1,0,0,1,1,0,1],
[0,0,1,1,1,1,0,1,1,1,1,1,0,1,1,1,0,1,1,1,0,1,1,1,0],
[0,1,1,0,1,1,1,0,0,0,0,0,1,1,1,0,1,0,1,1,0,0,1,1,1],
[0,0,0,1,0,0,1,1,1,1,1,1,1,1,1,1,0,0,1,0,0,1,1,1,1],
],
"23510":[
[1,1,0,0,1,1,1,1,1,0,1,1,1,1,1,0,0,1,1,0,0,0,0,0,1,1,1,1,1,0],
[1,0,1,0,0,1,1,1,1,0,1,1,1,1,0,0,1,0,0,1,0,0,0,1,0,0,1,1,0,1],
[1,1,0,1,1,0,1,1,1,0,1,1,1,0,0,0,1,0,1,1,1,1,1,1,0,1,0,1,1,0],
[1,1,1,1,1,1,0,0,1,0,1,1,1,0,0,0,0,1,1,0,0,0,0,0,1,1,0,1,1,0],
[0,0,1,1,1,0,0,1,1,0,1,1,1,1,0,0,1,1,1,1,0,1,1,0,0,0,1,1,1,0],
[0,1,0,0,1,0,1,0,1,0,1,1,1,1,0,0,1,1,0,0,0,0,0,0,1,0,1,1,0,1],
[1,0,1,1,1,0,0,1,1,0,1,1,0,1,1,0,1,0,0,1,0,0,1,0,1,1,0,1,1,0],
[1,1,1,0,0,1,0,1,1,0,1,1,1,0,0,0,1,0,0,0,1,0,0,0,1,1,0,1,1,0],
[1,1,1,0,1,1,1,1,1,0,1,1,0,1,0,0,1,1,0,1,1,1,0,0,1,0,1,1,1,0],
[1,0,1,0,0,1,1,1,1,0,1,1,1,0,0,0,0,1,1,0,0,0,0,1,1,0,1,1,1,0],
[0,1,0,1,0,0,1,1,1,0,1,0,0,0,1,1,1,0,0,1,1,1,1,1,0,1,1,1,0,1],
[0,0,1,1,1,1,1,1,1,0,1,0,0,1,1,0,0,0,0,0,0,0,1,1,0,1,0,1,1,0],
[1,1,1,1,1,1,1,1,0,0,1,0,1,0,0,1,1,1,0,0,1,1,1,0,1,0,0,0,1,0],
[0,0,0,0,0,0,0,0,0,1,1,0,1,0,1,1,1,0,0,1,1,1,1,1,0,1,1,0,1,1],
[1,1,1,1,1,1,1,1,1,1,1,0,1,0,0,0,1,0,0,1,1,0,0,0,1,1,1,0,1,1],
[1,1,1,1,1,1,1,1,1,0,0,0,0,1,1,1,1,0,0,0,1,0,1,1,1,0,0,1,1,1],
[1,1,1,1,0,1,0,1,0,1,0,0,0,0,0,1,1,0,1,1,1,0,0,0,0,1,1,1,1,1],
[1,1,1,1,1,0,1,0,0,0,0,0,0,1,1,1,1,0,0,1,1,1,1,1,1,0,1,1,1,1],
[1,1,1,1,1,1,1,1,1,1,1,1,1,1,1,1,0,0,1,1,1,0,1,1,1,0,0,1,1,1],
[0,0,0,0,0,0,0,0,0,0,0,0,0,0,0,1,0,0,1,1,0,1,0,1,1,1,0,0,0,1],
[1,1,0,0,1,1,1,0,0,0,0,1,1,1,1,1,0,1,1,1,0,1,0,0,0,1,1,0,0,1],
[1,1,1,1,1,0,0,1,1,1,1,0,0,1,1,1,0,1,1,0,1,1,1,1,0,0,0,0,0,1],
[1,1,1,1,1,1,1,1,1,1,1,1,1,1,1,1,0,0,1,0,1,1,1,1,1,1,1,1,1,1],
[0,0,0,0,0,0,0,0,1,0,0,0,0,0,1,1,0,1,0,1,1,1,1,1,1,1,1,1,1,1],
[1,1,1,1,1,1,0,0,0,1,1,1,1,1,1,1,1,1,0,1,1,1,1,1,1,0,0,0,1,0],
[1,1,0,0,0,0,0,1,1,0,0,1,1,0,0,0,1,0,1,0,0,0,0,0,1,1,1,1,0,0],
[1,1,1,1,1,1,1,1,1,1,1,1,0,0,0,0,1,1,1,1,1,0,0,1,1,1,1,1,1,1],
[0,0,0,0,1,1,1,1,1,1,1,0,0,1,1,1,1,1,1,1,0,0,1,1,1,0,0,0,0,0],
[1,1,1,0,0,0,0,0,0,1,0,0,0,0,0,0,0,0,0,0,0,1,1,0,0,0,1,1,1,1],
[0,0,0,1,1,0,1,1,1,1,1,1,1,1,1,1,1,1,1,1,1,1,1,1,1,1,0,0,1,1],
],
"23511":[
[1,1,1,0,1,1,1,0,1,1,1,1,1,1,1,1,1,1,1,1,1,1,1,1,1,1,1,1,1,1],
[0,0,0,1,0,0,0,1,0,0,0,0,0,0,0,0,0,0,0,0,0,0,0,0,0,0,0,0,1,0],
[1,1,1,1,1,1,1,1,1,1,1,1,1,1,1,1,1,1,1,1,1,1,1,1,1,1,1,1,1,1],
[0,0,0,1,0,0,0,1,0,0,0,0,0,0,0,0,0,0,0,0,0,0,0,0,0,0,0,0,1,0],
[1,1,1,1,1,1,1,1,1,1,1,0,0,0,0,1,1,0,0,0,0,1,1,0,0,0,1,1,1,1],
[0,1,0,0,1,0,1,1,1,0,1,1,0,0,1,0,0,1,0,0,1,0,0,1,0,0,1,0,0,1],
[0,0,1,1,1,0,0,1,1,0,0,1,0,0,1,0,1,1,1,1,1,0,1,1,0,0,1,0,1,1],
[1,0,1,1,0,1,0,1,0,1,0,1,0,0,1,1,1,1,1,0,0,1,1,1,0,1,0,0,1,1],
[1,0,0,1,0,1,1,1,0,1,1,1,0,0,1,1,1,0,0,0,0,0,0,1,0,1,0,1,1,1],
[1,0,0,0,0,1,1,0,0,1,0,0,0,0,1,1,0,1,0,0,1,0,0,1,1,0,1,1,1,0],
[0,1,1,1,1,1,1,1,1,1,0,0,0,1,1,1,0,1,0,0,1,0,0,0,1,0,0,0,0,0],
[0,0,0,0,0,0,0,0,0,0,0,0,1,1,1,0,0,0,1,0,0,0,0,0,1,1,0,0,0,0],
[0,1,0,0,0,0,0,0,1,0,0,1,1,0,1,1,0,1,1,1,0,0,0,1,0,1,1,0,0,0],
[1,0,1,0,0,0,0,1,0,1,0,1,0,0,0,1,1,0,0,0,0,0,0,0,0,0,1,0,0,0],
[0,1,0,0,0,0,0,0,1,0,1,1,0,0,0,1,1,1,1,1,1,0,0,0,0,0,1,1,0,0],
[0,0,0,0,0,0,0,0,0,0,1,0,0,0,0,1,1,1,1,1,0,0,1,0,0,0,0,1,0,0],
[0,1,1,1,1,1,1,1,0,1,1,0,1,0,1,1,1,1,1,0,0,1,1,0,0,1,0,1,1,0],
[1,0,0,0,0,0,0,1,1,0,1,0,1,1,0,0,1,1,1,1,1,1,0,0,1,1,0,1,1,1],
[1,0,1,1,1,0,0,1,1,0,1,1,0,1,0,0,1,1,0,0,1,1,0,0,1,0,1,0,0,1],
[1,0,1,1,0,0,1,1,0,1,1,1,0,0,0,1,1,0,1,0,0,1,1,0,0,1,1,0,0,1],
[1,0,1,1,0,0,1,0,0,0,1,1,1,1,1,1,1,1,1,0,1,1,1,1,1,1,1,1,0,0],
[1,0,1,0,1,0,1,0,0,1,1,1,0,0,1,1,0,1,0,0,1,1,1,1,0,1,1,1,0,0],
[1,0,1,1,0,0,0,1,0,0,0,0,1,0,1,0,1,0,0,1,0,0,1,0,1,0,0,0,0,1],
[1,0,1,1,1,1,0,1,0,0,0,1,1,1,0,0,0,0,0,0,1,0,0,0,0,0,1,0,0,1],
[1,0,0,0,0,0,0,1,1,1,1,0,1,1,1,1,0,0,1,1,1,1,0,1,1,0,1,1,1,0],
[1,1,1,1,1,1,1,1,1,1,1,0,0,1,1,1,1,1,1,1,1,1,1,1,1,1,1,0,1,1],
[0,1,1,1,1,1,1,1,1,1,1,1,0,1,1,0,1,1,1,0,0,1,1,1,1,0,0,1,0,0],
[0,0,1,0,1,1,0,1,0,0,1,1,0,0,0,1,0,0,1,0,1,1,1,1,0,0,0,1,1,1],
[0,1,0,1,0,0,1,0,1,1,1,1,1,1,0,0,0,0,0,0,0,0,0,0,0,1,1,1,1,1],
[0,0,0,0,0,1,0,1,1,1,1,1,1,1,1,1,1,1,1,1,1,1,1,1,1,1,1,1,1,1],
],
"23512":[
[0,0,1,1,1,1,1,1,1,1,1,1,1,1,1,0,0,0,1,0,1,0,0,1,0,0,0,0,0,0],
[0,0,1,1,1,1,0,0,0,1,1,1,1,0,0,0,1,1,1,0,1,0,1,0,1,1,0,0,0,0],
[1,0,1,1,0,0,0,1,0,0,0,1,0,1,1,1,1,0,1,0,1,0,0,1,0,0,0,0,0,0],
[1,0,1,1,1,1,1,0,1,1,0,1,1,1,1,1,1,0,1,0,1,0,0,1,0,0,0,0,0,0],
[1,1,1,1,0,0,0,1,0,0,0,1,1,0,1,1,0,1,1,1,1,0,0,0,1,1,1,0,0,0],
[1,1,1,0,1,1,1,0,1,0,1,1,0,0,1,1,1,1,0,1,1,0,0,1,1,0,1,1,0,0],
[0,0,1,1,1,0,0,1,1,0,0,1,0,0,1,1,1,0,1,0,1,1,1,1,0,1,0,1,0,0],
[1,1,1,1,1,1,1,0,0,1,0,1,1,0,1,1,1,0,1,1,0,0,0,0,1,1,0,1,0,0],
[1,1,1,0,1,1,0,0,1,1,0,0,1,0,1,1,1,1,0,0,0,0,0,0,0,1,1,0,0,0],
[1,0,1,0,0,1,1,1,1,1,1,0,1,1,1,1,1,1,0,0,0,0,0,0,1,1,1,1,0,0],
[0,0,1,1,0,1,1,0,1,1,1,1,1,0,0,1,1,0,0,0,1,0,0,1,0,0,1,1,0,0],
[0,0,1,0,0,1,1,0,0,1,1,1,0,1,0,0,1,0,0,0,0,0,1,0,0,0,1,1,0,0],
[1,0,1,1,0,1,0,1,0,1,1,1,0,1,1,0,1,0,1,1,0,1,1,1,0,1,1,1,0,0],
[1,0,1,1,0,1,1,1,1,0,0,1,1,1,1,0,1,1,0,0,0,0,0,0,1,1,1,0,0,0],
[1,1,1,1,1,1,0,0,0,1,1,1,0,0,1,1,0,1,1,1,0,0,0,0,0,1,0,1,0,0],
[1,1,0,0,0,0,1,1,1,1,1,0,1,1,0,1,1,1,1,1,1,1,1,1,1,0,0,0,1,0],
[0,0,1,1,1,1,1,1,1,1,1,0,0,1,0,1,1,1,1,1,1,1,1,1,1,0,1,0,1,0],
[1,1,1,1,0,1,0,0,1,1,0,1,1,0,1,0,1,1,1,1,1,1,1,0,0,0,1,0,1,0],
[1,0,1,0,1,1,1,1,1,1,0,0,0,1,0,1,0,0,1,1,1,0,0,0,1,1,1,0,1,0],
[0,1,1,1,0,1,1,0,1,1,0,1,1,1,1,0,1,1,0,0,1,0,1,1,1,1,0,0,1,1],
[1,0,1,0,0,1,0,0,1,1,1,0,0,0,0,1,1,1,1,1,1,0,0,1,0,0,1,0,0,1],
[0,0,1,1,0,1,0,0,1,1,1,1,1,1,1,1,0,1,1,1,1,1,0,0,1,1,1,0,0,1],
[0,0,1,1,0,1,1,0,1,1,1,1,1,1,1,1,0,0,1,1,1,1,1,1,1,1,1,1,0,1],
[0,0,1,0,0,1,1,0,1,1,1,1,1,1,1,1,0,0,1,1,0,0,0,1,1,1,1,0,0,1],
[1,0,1,1,0,1,1,0,1,1,1,1,0,0,0,1,0,1,1,1,1,0,1,1,1,1,0,1,0,1],
[1,0,1,1,0,1,1,1,1,0,0,0,0,1,1,0,1,0,1,1,1,0,0,1,1,1,1,0,0,1],
[1,1,1,1,1,1,0,0,0,0,1,1,1,1,0,0,0,1,1,1,0,0,1,0,0,1,1,0,1,1],
[1,1,0,0,0,0,0,1,1,1,1,1,1,1,0,0,1,1,1,1,0,0,0,1,1,1,0,0,1,1],
[0,0,0,1,1,1,1,1,1,1,1,1,1,1,0,0,0,0,0,1,0,0,0,0,0,0,0,0,1,1],
[1,1,1,1,1,1,1,1,1,1,1,1,1,1,1,1,1,1,1,1,1,1,1,1,1,1,1,1,1,1],
],
}