{"24701":[
[0,0,1,0,0,0,0,0,0,0,0,0,1,1,1,1,0,0,0,0,0,1,1,1,0],
[0,0,1,0,0,0,0,0,0,0,1,1,1,0,0,1,1,0,0,0,1,1,0,1,1],
[1,1,0,1,1,0,0,0,0,1,1,0,0,0,0,0,0,1,0,0,1,0,1,0,1],
[0,0,1,0,0,0,0,0,1,1,0,0,1,0,0,1,1,0,1,0,1,1,0,1,1],
[0,0,1,0,0,1,1,1,1,1,0,1,1,0,0,0,1,0,1,0,0,1,1,1,0],
[0,0,0,1,1,1,0,0,0,1,1,1,1,1,0,1,1,0,0,1,0,0,1,0,0],
[0,0,1,1,0,0,0,1,0,0,0,1,1,1,1,1,1,1,0,1,1,1,1,1,1],
[0,0,1,0,0,1,0,1,1,0,0,0,0,1,1,1,1,1,1,0,0,0,0,0,0],
[0,1,1,0,0,1,1,1,1,1,0,1,0,0,1,1,1,1,0,0,0,1,0,0,1],
[0,1,0,0,1,0,1,1,0,0,1,1,1,0,0,1,0,1,0,0,1,0,1,1,1],
[0,1,0,0,1,1,0,0,1,0,0,1,1,0,1,0,1,0,0,0,0,1,1,0,1],
[1,1,0,1,1,1,0,1,1,0,1,1,0,1,1,0,1,0,0,1,0,0,0,1,1],
[1,1,0,1,1,0,1,0,1,1,1,1,1,1,1,0,1,1,1,0,1,0,1,1,1],
[1,0,1,1,1,1,1,1,1,1,1,1,1,1,0,1,1,1,1,1,1,1,1,1,1],
[1,0,1,1,1,1,1,1,0,0,0,1,1,0,0,1,1,1,1,1,1,1,1,1,1],
[1,1,1,1,1,1,0,0,0,0,0,0,0,0,1,1,1,0,0,1,1,1,0,0,1],
[1,1,1,1,1,1,0,0,0,0,1,1,1,1,1,1,1,0,1,1,1,1,1,0,1],
[1,1,1,1,1,1,0,0,0,1,1,0,1,1,1,1,1,1,0,0,0,0,0,1,1],
[0,0,1,1,1,0,0,0,1,1,1,1,0,0,1,1,1,0,0,0,0,1,0,0,1],
[0,0,0,0,0,0,1,0,1,0,0,0,1,1,1,1,1,0,0,0,0,1,1,0,1],
[1,0,0,0,0,1,0,1,1,1,0,0,1,1,1,0,1,0,0,1,1,1,1,0,1],
[1,1,1,0,1,1,0,1,1,0,1,0,1,1,1,0,0,1,0,0,0,0,0,1,0],
[1,1,1,1,1,0,0,1,1,1,0,0,0,1,1,0,0,0,1,1,1,1,1,1,0],
[1,1,0,0,0,0,1,1,0,0,0,1,1,0,1,1,0,0,0,0,1,1,1,0,1],
[0,0,0,1,1,1,1,1,1,0,0,0,0,1,1,1,1,0,0,0,0,1,1,1,0],
],
"24702":[
[1,1,1,0,1,1,1,1,1,0,1,1,1,1,1,1,1,1,0,0,0,0,1,1,1],
[1,0,0,0,0,0,1,1,0,1,0,1,1,1,1,1,1,0,0,0,0,0,0,1,1],
[1,1,0,0,0,1,1,1,1,0,1,1,1,1,1,1,0,0,0,0,1,1,0,0,1],
[1,1,0,1,0,1,1,1,1,1,1,0,1,1,1,1,0,0,0,1,1,1,1,1,1],
[1,1,1,1,1,1,0,1,1,0,0,0,0,0,1,1,0,0,0,1,1,1,1,1,1],
[1,1,1,1,1,0,1,0,1,1,0,0,0,1,1,1,0,0,0,1,1,1,1,0,1],
[1,0,1,1,1,1,0,1,1,1,0,1,0,1,1,1,0,0,0,0,1,1,0,0,1],
[0,1,0,1,1,1,1,1,1,1,1,1,1,1,1,1,1,0,0,0,0,0,0,1,1],
[1,0,1,1,0,0,0,1,1,1,0,0,0,1,1,1,1,1,0,0,0,0,1,1,1],
[1,1,1,0,1,1,1,0,0,0,1,1,1,0,1,1,1,1,1,1,1,1,1,1,1],
[1,1,1,0,1,0,1,1,0,1,1,0,1,0,1,0,0,0,1,1,1,1,0,1,1],
[1,1,1,0,1,0,0,1,0,1,0,0,1,0,0,0,1,1,0,1,0,0,0,0,0],
[1,1,1,0,1,0,1,1,1,1,1,0,1,1,0,0,1,0,1,0,1,0,0,0,1],
[1,1,1,0,1,1,1,0,0,0,1,1,0,1,1,1,1,0,1,0,1,0,1,0,1],
[1,1,1,0,0,1,0,1,0,1,0,1,0,0,1,0,0,1,1,0,1,1,1,1,1],
[1,1,1,1,0,1,0,0,0,0,0,1,0,0,1,1,1,1,0,0,1,1,1,0,1],
[1,1,1,0,0,0,1,1,1,1,1,1,1,0,1,0,0,0,0,1,1,1,0,1,0],
[1,1,0,0,1,1,0,0,0,0,0,0,1,1,1,0,0,0,1,1,1,1,1,0,1],
[1,0,0,1,0,0,0,1,1,1,0,0,0,0,1,1,1,0,0,0,0,0,0,1,1],
[1,0,1,1,0,0,0,0,1,1,0,1,1,0,0,0,1,1,1,1,1,1,0,0,0],
[0,0,1,0,1,1,0,1,1,1,1,1,0,1,1,0,0,1,0,0,0,1,1,1,0],
[0,1,0,0,1,0,0,0,0,0,1,1,0,0,0,1,0,1,1,1,0,0,0,1,1],
[0,1,0,1,1,0,0,1,0,1,1,1,1,0,1,1,0,0,1,1,1,1,0,0,1],
[1,1,0,1,1,1,1,0,1,1,1,0,0,1,1,1,1,0,0,1,1,0,1,0,1],
[1,0,0,0,1,1,1,1,1,1,1,1,1,1,1,1,1,0,0,1,1,1,0,0,0],
],
"24703":[
[0,0,0,0,0,0,0,0,0,0,0,0,0,0,0,0,0,0,1,1,1,1,1,0,0],
[0,0,0,0,0,0,0,0,0,0,0,0,0,0,0,0,1,1,1,0,0,0,1,1,0],
[0,1,1,1,1,0,0,0,0,0,0,0,0,0,0,1,0,0,0,0,0,0,0,1,1],
[1,1,1,1,1,1,1,0,0,0,0,0,0,0,0,1,1,1,0,1,0,1,0,1,1],
[1,1,1,0,0,1,1,1,0,0,0,0,0,0,0,1,1,0,1,0,1,0,1,1,1],
[0,0,0,1,1,0,1,1,0,0,0,1,1,1,0,0,1,1,0,1,1,1,1,1,0],
[0,0,0,0,1,1,0,1,1,0,1,0,0,1,1,0,0,1,1,1,1,1,0,0,1],
[1,0,0,1,0,1,1,0,1,0,1,1,1,0,1,1,0,0,0,0,0,0,0,1,1],
[1,0,0,1,1,1,1,0,1,0,0,1,1,1,1,1,0,0,0,0,0,0,0,1,0],
[1,1,1,1,1,1,0,0,1,0,0,0,0,0,0,0,0,0,0,0,0,0,1,1,0],
[0,1,1,0,1,0,0,1,1,0,0,1,1,0,0,0,0,0,1,0,0,1,1,0,0],
[1,0,0,0,0,0,1,1,0,0,1,1,1,1,0,0,0,1,1,1,0,1,0,0,0],
[0,1,1,1,1,1,1,0,0,1,1,0,1,1,1,0,1,0,1,1,1,1,0,0,1],
[0,0,1,0,1,0,0,0,1,1,0,1,0,1,1,1,0,0,1,1,1,0,0,0,1],
[0,0,1,0,1,0,0,1,1,0,1,0,1,1,1,0,0,1,0,1,0,0,1,0,1],
[0,0,1,1,1,1,1,1,1,1,1,1,1,0,0,0,0,1,1,1,0,0,1,1,1],
[0,1,1,0,0,0,0,0,0,1,1,1,0,0,0,1,1,1,1,0,0,0,0,1,1],
[1,1,0,0,1,1,0,1,0,0,0,0,1,1,1,1,1,1,0,1,0,1,0,1,1],
[0,0,1,1,1,0,1,0,1,0,0,0,0,0,1,1,0,0,0,1,1,0,1,1,1],
[0,1,1,0,1,1,1,0,1,1,1,0,1,0,0,0,1,1,1,1,1,1,1,1,1],
[0,1,0,1,0,1,1,1,1,0,1,1,1,1,1,0,0,0,0,1,1,1,1,1,1],
[0,1,1,0,1,1,1,1,0,1,0,1,1,1,1,0,0,1,0,0,0,0,1,1,1],
[1,0,1,1,1,1,0,1,1,0,1,1,1,1,0,1,1,0,1,0,1,0,0,0,0],
[1,1,1,1,1,0,1,0,1,1,1,1,1,1,1,1,0,1,1,1,1,1,1,1,0],
[1,1,1,1,1,1,0,1,1,1,1,1,1,1,1,1,1,1,1,1,1,1,1,1,1],
],
"24704":[
[0,0,0,0,1,1,0,1,1,0,0,0,0,0,0,0,0,0,0,0,0,1,1,1,0,1,1,0,1,1],
[0,0,0,0,0,0,1,0,0,0,1,1,1,1,1,0,0,0,0,0,1,1,0,1,1,0,0,1,0,0],
[0,0,1,1,1,0,0,0,0,1,1,0,0,0,1,1,0,0,0,1,1,0,1,0,1,1,0,0,0,0],
[0,1,1,1,1,1,0,0,0,1,0,1,0,1,0,1,0,0,1,1,0,1,1,1,0,1,1,0,0,0],
[1,1,0,0,0,1,1,0,0,1,0,1,1,0,0,1,0,1,1,0,1,1,0,1,1,0,1,1,0,0],
[1,0,1,0,1,0,1,0,0,1,0,1,1,1,0,1,0,1,0,1,1,1,1,1,1,1,0,1,0,0],
[1,0,1,1,0,0,1,0,0,1,1,0,0,0,1,1,0,1,1,0,1,0,0,0,0,0,1,1,0,0],
[1,0,1,1,1,0,1,0,0,0,1,1,1,1,1,0,0,0,1,0,0,1,1,1,0,0,1,0,0,0],
[1,1,0,0,0,1,0,0,0,0,0,1,0,1,0,0,0,0,1,0,0,1,0,1,0,0,1,0,0,0],
[0,1,1,1,1,0,0,0,0,0,1,1,1,1,1,1,1,1,1,1,0,1,0,1,0,0,1,0,0,0],
[0,0,1,0,1,0,1,1,1,1,1,0,0,0,0,0,0,0,0,1,1,1,1,1,1,0,1,0,0,0],
[0,0,1,1,1,1,1,0,0,0,0,0,0,1,0,0,0,0,1,0,0,0,0,0,1,1,1,0,0,0],
[0,1,1,1,0,0,0,1,0,0,0,1,0,1,1,1,1,0,1,1,1,0,1,1,0,0,1,1,1,0],
[1,1,0,0,0,0,1,0,1,0,1,0,1,1,1,0,1,1,1,1,1,1,1,1,1,1,0,0,1,1],
[0,0,0,1,0,1,0,1,0,0,0,1,0,1,0,1,0,1,1,0,0,1,1,1,0,0,1,0,0,0],
[0,1,1,0,1,1,1,0,1,1,1,0,1,1,1,0,1,1,1,0,0,1,1,1,0,0,1,1,0,0],
[0,0,0,1,1,1,1,1,1,1,1,1,1,1,0,1,1,0,1,0,0,0,1,0,0,0,1,1,0,1],
[1,0,1,1,0,0,1,1,1,0,0,1,1,1,0,1,0,1,0,1,0,0,1,0,0,1,1,0,1,0],
[1,0,1,1,0,0,1,1,1,0,0,1,1,0,1,0,1,0,1,1,0,1,1,1,0,1,1,1,0,1],
[1,1,1,1,1,1,0,0,0,1,1,1,1,1,0,1,1,1,1,1,1,0,0,0,1,1,1,0,1,0],
[1,1,1,1,0,0,0,0,0,0,0,1,1,1,1,1,1,1,1,0,0,0,0,0,0,0,1,1,0,1],
[1,1,1,0,0,0,1,0,1,0,0,0,1,1,1,1,1,1,0,0,0,1,0,1,0,0,0,1,1,1],
[1,1,1,0,0,0,1,0,1,0,0,0,1,1,1,1,1,1,0,0,0,1,0,1,0,0,0,1,1,1],
[1,0,1,1,1,0,0,0,0,0,0,1,1,0,1,1,0,1,1,0,0,0,0,0,0,0,1,1,0,1],
[1,0,0,0,1,1,0,0,0,1,1,1,0,0,1,1,0,0,1,1,1,0,0,0,1,1,1,0,0,1],
[1,0,1,1,0,0,0,0,0,0,0,0,0,0,1,1,0,1,0,0,0,0,0,0,0,0,0,0,0,1],
[1,1,0,1,1,0,1,0,0,0,0,0,0,1,1,1,1,0,1,1,0,1,0,0,0,0,0,0,1,1],
[1,1,0,0,1,1,0,1,1,0,0,0,0,1,1,1,1,0,0,1,1,0,1,1,0,0,0,0,1,1],
[1,1,1,0,1,1,1,1,0,0,0,0,1,1,1,1,1,1,0,1,1,1,1,0,0,0,0,1,1,1],
[1,1,1,0,1,1,1,1,1,1,0,0,1,1,1,1,1,1,0,1,1,1,1,1,1,0,0,1,1,1],
],
"24705":[
[0,0,0,1,0,0,0,0,0,0,0,0,0,0,0,0,0,1,1,1,0,0,0,0,0,0,0,0,0,0],
[0,0,0,1,0,0,0,0,0,0,0,0,0,0,0,0,1,1,1,1,1,0,0,0,0,0,0,0,0,0],
[0,0,1,0,1,0,0,0,0,0,0,0,0,0,0,1,1,0,0,1,1,1,0,0,0,1,1,0,0,0],
[1,1,0,1,0,1,1,0,0,1,1,1,1,0,1,1,0,0,0,1,1,1,0,0,1,0,1,1,0,0],
[0,0,1,0,1,0,0,0,1,1,0,0,1,1,1,1,0,0,0,0,1,1,1,0,1,0,1,1,0,0],
[0,0,0,1,0,0,0,1,1,0,0,1,1,1,1,0,0,0,1,0,1,1,0,1,0,1,0,1,1,0],
[0,0,0,1,0,1,1,1,0,0,1,1,1,0,0,0,1,0,1,0,1,1,0,1,1,1,1,0,1,1],
[0,0,0,0,1,1,0,0,1,0,0,0,0,0,1,1,1,0,1,1,1,0,1,0,1,1,0,0,1,1],
[0,0,1,1,1,0,1,1,1,0,0,1,1,1,1,1,1,1,1,1,1,1,0,0,0,1,1,0,0,1],
[0,0,1,0,0,0,0,1,1,1,1,0,0,0,0,0,0,0,1,1,1,1,0,1,0,1,1,0,0,1],
[0,1,1,0,1,0,1,1,1,0,0,0,1,1,1,1,1,0,0,0,0,1,1,1,0,0,1,1,0,0],
[1,1,0,0,1,1,1,1,0,0,1,1,0,0,0,0,0,1,1,1,0,0,0,1,1,0,0,1,0,0],
[1,0,0,1,1,1,1,1,0,1,1,1,1,1,1,1,1,0,0,0,1,1,0,1,1,0,0,0,0,0],
[0,0,1,1,1,1,1,0,1,0,0,0,1,0,0,1,1,1,1,0,0,1,0,0,1,1,0,0,0,1],
[0,1,1,0,0,0,1,1,0,0,1,0,0,1,0,1,0,0,1,1,0,0,1,0,1,1,0,0,1,1],
[0,1,0,0,1,0,0,0,0,1,0,1,0,1,0,0,0,1,1,1,1,0,1,0,0,1,0,1,1,1],
[0,1,0,1,1,1,0,0,1,1,1,1,0,1,0,1,0,1,1,1,1,0,0,1,0,1,1,0,1,1],
[0,1,0,0,1,1,1,1,0,1,1,0,0,1,0,1,1,1,1,1,1,1,0,1,0,1,1,1,1,1],
[0,0,1,0,0,0,1,1,1,0,0,1,1,1,0,0,1,1,1,1,1,1,1,1,1,1,1,1,1,1],
[0,1,0,1,1,1,0,0,0,1,1,1,1,1,1,0,1,1,0,0,0,1,1,0,0,0,0,1,1,1],
[1,1,1,0,0,1,1,1,1,1,1,1,1,1,1,1,1,0,0,1,0,0,1,0,1,1,0,0,1,1],
[1,1,0,1,1,1,1,1,1,1,1,1,1,1,1,1,1,0,1,1,1,0,0,0,0,1,1,0,1,1],
[1,0,1,1,1,1,1,1,1,1,1,1,1,0,0,0,1,0,0,1,1,1,1,0,1,1,0,0,1,1],
[1,1,0,0,0,1,1,1,1,1,1,1,1,0,0,1,1,1,0,0,0,1,1,1,0,0,1,1,0,1],
[1,0,0,0,0,0,0,1,1,0,0,0,1,0,0,0,1,1,1,1,1,0,0,0,1,1,1,0,0,0],
[0,0,1,0,1,1,1,0,0,0,0,0,0,0,0,1,0,0,1,0,1,1,1,1,1,1,1,0,1,0],
[0,1,1,0,0,1,1,0,1,0,1,1,0,1,0,1,1,1,0,0,1,1,1,1,1,1,1,0,1,1],
[1,1,0,0,1,0,0,0,1,1,0,1,1,1,1,0,1,1,0,0,0,0,1,1,1,0,1,1,1,1],
[1,1,1,1,1,0,1,1,1,1,1,0,1,1,0,1,1,1,1,1,0,1,1,0,1,0,1,1,1,1],
[1,1,1,1,1,1,0,1,1,1,0,0,0,0,1,0,0,1,1,1,1,0,0,1,0,1,1,1,1,1],
],
"24706":[
[0,0,1,1,1,1,0,1,1,1,1,1,0,1,1,0,1,1,1,0,0,0,0,0,0,0,0,0,0,0],
[0,1,1,0,1,0,0,0,1,1,1,0,0,0,0,1,0,1,1,0,0,0,0,0,0,0,1,1,1,0],
[0,1,1,0,1,1,0,0,1,0,0,1,0,0,1,1,1,1,0,0,0,0,0,0,0,1,0,0,0,1],
[0,1,0,0,1,1,1,1,0,1,1,1,1,0,0,1,1,1,0,0,0,0,0,0,1,0,0,1,1,1],
[0,1,0,1,1,1,0,0,1,1,0,1,1,1,1,1,0,0,0,1,0,1,0,0,1,0,1,0,1,1],
[0,0,0,1,0,0,0,1,0,0,1,1,1,1,1,0,0,0,0,1,1,1,0,1,0,0,0,1,1,1],
[0,0,0,1,1,0,0,1,1,1,0,1,1,0,0,0,0,0,0,0,1,0,0,1,0,1,0,0,0,1],
[0,0,1,1,0,1,0,1,0,0,0,0,0,0,0,0,0,0,0,0,0,0,0,1,1,1,0,1,1,1],
[0,0,1,1,1,1,1,0,1,1,1,0,0,0,1,1,0,0,0,0,1,1,1,0,1,1,1,1,1,1],
[0,0,1,1,1,0,0,1,1,0,0,1,0,1,0,0,1,0,0,1,1,0,1,1,0,1,1,1,1,1],
[0,0,1,0,0,0,0,1,0,1,0,1,1,1,0,1,0,1,0,1,0,1,0,1,0,0,1,1,1,0],
[0,0,1,0,0,0,0,1,0,1,1,0,0,0,1,1,0,1,0,1,1,0,1,1,0,0,1,0,1,0],
[0,0,1,0,0,0,0,0,1,0,0,0,1,1,0,0,1,0,0,0,1,1,1,0,0,0,1,0,1,0],
[0,0,1,0,0,0,0,1,1,0,0,0,0,0,0,0,1,0,0,0,0,1,0,0,0,1,1,1,1,1],
[1,0,1,0,0,0,0,1,0,0,0,1,0,1,0,0,0,1,0,0,1,1,1,1,1,0,0,0,0,0],
[1,0,1,0,0,0,0,1,0,0,0,1,0,1,0,0,0,1,1,1,1,0,0,0,0,0,1,0,0,1],
[1,0,1,0,0,0,0,1,1,0,0,0,0,0,0,0,1,1,0,0,0,1,1,0,0,1,0,1,1,1],
[1,0,1,0,0,1,1,1,1,1,1,0,0,0,1,1,1,0,0,0,0,1,1,1,0,0,0,0,1,1],
[1,0,1,1,1,1,0,0,1,1,1,1,1,1,0,0,1,1,0,1,0,1,1,0,0,0,1,1,1,1],
[1,0,0,1,0,0,0,1,0,0,1,1,1,0,1,0,0,1,1,0,1,0,1,1,0,1,1,1,1,1],
[1,1,0,1,0,0,1,1,0,1,1,1,1,1,1,1,0,1,1,0,1,0,1,0,1,0,1,1,1,1],
[1,1,0,1,0,1,1,0,0,0,1,1,1,1,1,0,0,0,1,1,0,1,1,1,0,1,1,0,1,1],
[1,0,0,1,0,1,1,0,1,0,0,0,1,0,0,0,1,0,1,1,1,0,1,1,1,1,0,1,0,1],
[1,0,0,1,1,0,1,0,0,1,1,0,1,0,1,1,0,0,1,1,0,1,1,1,1,1,1,0,1,1],
[1,0,0,1,0,1,1,1,1,0,0,0,1,0,0,0,1,1,1,1,1,1,1,1,1,0,1,1,1,0],
[1,1,0,1,1,0,1,1,0,1,1,1,1,1,1,1,0,1,1,1,1,1,1,1,0,1,0,1,0,1],
[1,1,0,0,1,1,1,1,0,1,1,0,1,0,1,1,0,1,1,1,1,1,0,1,1,0,1,1,0,1],
[1,1,0,0,1,1,1,1,0,1,0,0,1,0,0,1,0,1,1,1,1,0,1,0,1,1,1,0,1,0],
[1,1,1,0,1,1,1,1,0,0,0,0,1,0,0,0,0,1,1,1,1,1,0,1,1,0,1,1,0,1],
[1,1,1,0,0,1,1,1,1,1,1,1,1,1,1,1,1,1,1,1,1,1,0,1,0,1,0,1,1,1],
],
"24707":[
[0,0,0,1,1,1,1,0,0,0,0,0,0,0,0,0,1,1,1,1,0,0,0,0,0],
[0,1,1,0,0,0,1,1,0,0,0,0,0,0,1,1,1,0,0,1,1,1,0,0,0],
[1,1,0,1,1,0,0,1,0,0,0,0,0,1,1,0,0,0,1,1,1,1,1,0,0],
[0,1,1,1,1,1,1,0,0,0,0,0,1,1,0,1,1,0,0,1,1,0,0,1,0],
[0,0,0,0,1,0,0,0,1,0,0,0,1,0,1,0,1,1,0,0,1,0,1,1,0],
[0,0,0,1,1,1,0,1,1,1,0,1,1,1,0,1,0,0,0,0,0,1,1,1,1],
[0,0,0,1,0,1,1,1,0,1,0,1,0,1,1,1,1,0,1,0,0,0,1,1,1],
[0,0,0,1,0,1,1,1,0,1,0,1,0,1,1,0,1,1,1,0,1,1,1,0,1],
[0,0,0,1,1,0,1,0,1,1,0,1,0,0,0,0,1,1,0,1,0,1,0,0,1],
[0,0,0,0,1,1,1,1,1,0,0,1,1,0,1,1,0,1,1,1,1,0,0,1,1],
[0,0,0,1,1,0,0,0,1,1,0,0,1,1,1,0,0,0,1,1,1,1,0,1,0],
[0,0,0,1,0,1,0,1,0,1,1,0,0,1,1,1,1,1,1,1,1,0,1,1,0],
[0,0,1,1,0,1,0,1,0,1,1,0,0,0,1,1,1,1,0,0,0,1,1,0,0],
[0,0,1,0,1,0,0,0,1,1,0,0,0,0,0,0,1,1,1,1,1,1,0,0,0],
[0,0,1,0,0,1,1,1,0,1,1,1,0,0,0,0,1,0,0,1,1,0,0,1,0],
[0,0,1,1,0,0,0,0,0,0,0,1,1,1,1,0,1,0,1,1,1,0,1,0,1],
[0,1,1,1,0,0,0,0,0,1,1,0,0,0,1,1,1,1,1,1,1,0,0,1,0],
[1,1,0,1,0,0,0,0,0,1,0,0,1,0,0,0,0,0,0,1,1,1,1,0,0],
[0,0,1,1,0,0,1,1,0,1,1,1,1,0,1,0,0,0,0,0,0,0,1,1,1],
[0,1,1,0,0,1,1,0,0,1,1,1,0,1,0,1,0,0,1,0,0,1,0,0,1],
[1,0,1,1,1,1,1,1,1,1,1,1,1,0,1,0,0,1,0,1,1,0,1,0,0],
[0,1,1,1,1,1,1,1,1,1,0,1,0,1,0,1,1,0,1,1,0,1,0,1,1],
[1,1,1,0,1,1,1,0,0,0,1,0,1,1,1,0,1,1,1,0,1,0,1,1,1],
[1,1,0,0,0,0,0,1,0,1,1,1,1,1,1,1,1,1,1,0,1,1,1,1,1],
[1,1,1,0,0,0,1,0,1,0,1,1,1,1,1,1,1,1,1,1,1,1,1,1,1],
],
"24708":[
[1,1,1,0,0,0,0,0,0,0,0,0,0,0,0,0,0,1,1,1,0,0,1,1,1],
[1,1,0,0,0,0,0,0,1,1,1,0,0,0,0,0,1,1,0,1,1,0,0,1,1],
[1,0,1,1,1,0,0,1,1,0,1,1,0,0,0,0,1,0,1,0,1,1,1,0,1],
[0,1,1,0,1,1,0,1,0,1,0,1,0,0,0,0,1,1,0,1,1,0,1,1,0],
[0,1,0,1,0,1,0,1,1,0,1,1,0,0,0,0,0,1,1,1,0,1,0,1,0],
[0,1,1,0,1,1,0,0,1,1,1,0,0,0,0,0,0,0,1,1,1,0,1,1,0],
[0,0,1,1,1,0,0,0,0,1,0,0,0,0,1,1,1,1,1,0,1,1,1,0,0],
[0,0,0,1,0,0,0,1,1,1,0,0,0,1,1,0,0,1,1,1,0,1,0,0,0],
[0,0,0,1,0,1,1,1,0,1,1,1,1,1,0,1,0,0,0,1,1,1,0,0,0],
[0,0,0,1,1,1,0,0,0,1,0,0,1,1,1,1,1,1,0,0,1,1,0,0,0],
[0,0,0,1,1,0,0,0,0,0,0,1,0,0,0,1,1,0,1,0,0,1,1,0,0],
[0,0,1,1,0,1,0,1,0,0,1,0,1,0,1,0,1,1,0,1,0,0,1,0,0],
[0,0,1,0,1,1,0,1,0,1,0,1,1,1,1,0,0,1,1,1,1,0,1,0,0],
[0,0,1,0,1,1,1,0,1,1,1,1,1,1,1,1,0,1,1,1,1,1,1,0,0],
[0,1,1,1,1,1,1,1,1,1,1,1,1,1,1,1,1,0,0,0,0,0,1,1,0],
[1,1,0,0,0,0,1,1,1,1,1,1,1,0,0,0,1,1,0,0,1,1,0,1,1],
[1,0,0,0,0,1,1,0,0,0,1,1,0,0,1,0,0,0,0,0,0,1,1,0,1],
[1,0,0,0,0,1,0,1,1,0,0,0,0,1,1,1,0,0,1,0,1,0,1,0,1],
[1,0,1,1,0,0,0,1,1,1,0,0,1,0,1,0,0,0,0,1,0,1,1,0,1],
[1,0,1,0,0,0,1,1,0,1,1,0,0,1,1,0,1,0,1,1,1,1,0,1,1],
[1,1,1,0,0,0,0,0,1,1,1,1,1,1,0,1,1,0,1,1,0,0,0,1,0],
[0,1,1,1,1,0,0,1,1,1,0,1,1,1,1,1,0,1,0,0,0,1,1,1,0],
[1,0,1,1,0,0,0,0,0,1,0,0,1,1,0,0,0,0,1,1,1,1,0,0,1],
[1,1,0,1,1,1,0,0,1,1,1,1,0,0,0,1,1,1,1,0,0,0,0,1,1],
[1,1,1,0,0,1,1,1,1,0,0,1,1,1,1,1,1,1,0,0,0,0,1,1,1],
],
"24709":[
[0,0,0,0,1,0,0,0,0,0,0,0,0,0,0,0,0,0,0,0,1,1,1,0,0],
[1,0,1,0,0,1,1,0,0,0,1,1,1,1,1,0,0,0,0,1,1,0,0,0,0],
[0,1,1,1,0,0,1,0,0,1,1,0,0,0,1,1,1,0,0,1,0,1,0,1,0],
[1,1,1,0,1,1,1,0,1,0,0,0,1,0,0,1,1,0,0,1,1,1,1,0,1],
[0,1,1,1,1,1,0,0,1,1,1,1,0,1,1,1,0,0,0,0,0,1,1,1,1],
[0,0,0,0,0,0,0,0,0,0,1,1,1,1,0,0,1,1,1,1,1,0,0,0,0],
[0,0,0,1,1,1,1,0,0,0,0,0,0,0,1,1,1,0,0,0,1,1,1,0,0],
[0,1,1,1,0,0,1,1,1,0,0,0,1,1,1,0,0,0,1,0,0,0,1,1,0],
[1,1,0,0,0,0,0,0,1,1,0,1,1,0,0,0,0,1,0,1,0,1,0,1,1],
[1,1,0,0,1,0,1,1,0,0,1,1,0,0,1,1,1,0,1,1,1,1,1,0,1],
[1,0,1,1,0,0,0,1,1,0,0,0,1,1,1,1,1,1,1,1,1,1,1,1,1],
[1,0,0,1,1,0,1,1,0,1,1,1,0,1,1,1,1,1,1,1,1,1,1,1,1],
[0,1,1,1,0,1,0,0,1,1,1,1,1,0,1,1,1,0,0,0,0,0,0,0,0],
[1,1,1,1,1,1,1,1,1,1,0,1,1,0,1,0,0,1,1,0,1,1,0,0,0],
[1,1,1,1,1,1,0,0,0,0,1,1,0,1,1,0,1,0,1,1,1,0,1,0,0],
[1,1,0,0,0,0,0,1,1,1,1,0,1,1,0,0,1,1,0,0,0,1,1,0,0],
[0,0,0,0,0,1,1,1,1,0,0,1,1,0,0,0,1,0,1,0,1,0,1,0,0],
[0,1,0,1,0,1,1,0,0,1,1,0,0,0,0,1,1,0,1,0,1,0,1,1,0],
[0,0,1,1,1,0,0,0,1,1,0,0,0,0,1,1,0,1,0,0,0,1,0,1,0],
[0,1,0,1,0,0,0,1,0,0,0,0,1,1,1,1,0,0,1,1,1,0,0,1,0],
[1,0,1,1,0,0,0,1,1,0,1,0,0,1,1,1,1,0,0,0,0,0,1,1,0],
[0,1,1,0,0,1,0,1,1,1,0,1,0,0,0,1,1,1,0,0,0,1,1,0,1],
[0,1,1,0,1,1,0,0,1,1,1,1,0,1,0,0,1,1,0,0,0,1,1,1,0],
[1,0,1,0,1,1,1,0,0,1,1,1,1,1,1,1,1,0,0,1,0,0,1,1,1],
[0,1,1,1,0,1,1,1,1,0,0,1,1,1,1,1,1,1,1,1,1,1,1,1,1],
],
"24710":[
[0,1,1,1,1,0,0,0,0,0,0,0,0,0,0,0,0,0,0,0,0,0,0,0,0,0,0,1,1,1],
[1,1,0,0,0,1,1,1,0,0,0,0,0,0,0,0,0,0,0,0,0,1,1,1,0,1,1,1,0,0],
[1,0,0,1,0,1,0,0,1,0,0,0,0,0,0,0,0,0,0,0,1,1,0,0,1,1,0,0,0,0],
[1,0,0,1,1,1,0,0,1,0,0,0,0,0,0,1,1,1,0,1,1,0,0,1,0,1,0,1,0,1],
[0,0,1,0,1,0,1,0,0,1,0,0,0,0,1,1,0,0,1,1,0,0,1,1,1,0,0,1,0,1],
[0,0,1,1,0,1,1,1,1,1,1,0,0,1,1,0,1,1,1,0,1,0,1,1,0,0,1,1,1,1],
[1,1,0,0,1,1,0,1,1,0,1,0,1,1,0,0,1,1,0,0,1,1,0,0,1,0,1,1,1,1],
[1,0,0,1,1,1,1,0,0,0,1,0,1,0,1,1,1,0,0,1,1,0,0,1,1,1,1,1,1,1],
[1,1,0,0,1,0,1,1,1,1,0,1,1,1,1,0,0,1,1,1,0,0,1,1,1,1,0,0,0,0],
[1,1,1,1,0,1,0,1,1,0,0,1,1,1,0,1,0,1,1,1,1,1,0,0,0,0,0,0,1,0],
[0,1,0,0,0,0,1,1,0,0,1,1,1,0,0,1,1,1,1,0,0,0,1,0,1,0,1,0,0,1],
[0,0,1,1,1,1,0,0,0,1,1,1,1,1,1,0,0,0,0,0,0,1,0,1,1,1,0,0,1,0],
[0,0,1,0,1,0,0,0,0,1,1,1,1,0,0,0,0,1,0,1,0,1,1,1,1,1,1,1,0,1],
[1,1,1,0,1,0,0,0,1,1,0,0,0,0,1,0,0,0,1,0,1,1,1,1,0,1,1,0,1,1],
[1,1,1,0,1,1,1,1,0,0,0,0,1,1,0,1,0,1,0,1,1,1,1,0,1,0,1,1,1,1],
[1,1,1,0,1,0,0,0,1,1,1,1,1,1,1,1,0,1,1,1,1,1,0,1,0,1,0,1,1,1],
[0,1,1,1,1,1,0,0,0,0,0,0,1,1,1,1,1,1,1,1,1,0,1,0,0,0,1,0,1,1],
[0,0,0,0,0,0,0,1,0,0,0,0,0,0,0,1,1,1,1,1,1,1,0,0,0,0,0,1,1,1],
[0,1,0,1,0,0,1,0,1,0,1,0,0,1,0,0,0,1,1,1,0,1,0,1,1,1,0,1,1,1],
[1,1,1,0,1,0,0,1,0,1,0,1,1,0,1,0,0,0,0,0,0,1,0,1,0,1,0,1,1,1],
[1,0,0,1,0,0,0,0,1,0,1,0,1,1,0,1,1,0,1,1,1,1,0,1,0,1,0,1,1,1],
[1,1,1,1,0,1,0,1,0,1,0,1,1,1,1,1,1,1,0,0,0,0,1,1,1,1,0,1,1,1],
[1,1,1,0,1,0,1,1,0,1,1,1,1,1,1,0,0,0,0,0,1,0,0,0,0,0,1,1,1,1],
[1,1,1,1,0,1,1,1,1,1,1,1,0,0,0,0,0,1,0,1,0,1,1,0,0,0,0,0,0,1],
[1,1,1,1,1,1,1,1,1,1,0,0,0,0,1,0,0,0,1,0,1,1,1,1,0,1,1,0,0,0],
[1,1,1,1,1,1,1,1,1,0,1,0,1,1,0,1,0,0,0,1,0,0,1,1,1,1,0,1,1,0],
[1,1,1,1,1,1,1,0,0,0,0,1,1,1,1,0,0,1,1,1,1,1,1,1,0,1,1,1,1,1],
[1,1,1,1,1,1,0,1,0,1,1,1,1,0,0,1,1,0,1,1,1,1,1,0,1,0,1,1,0,1],
[1,1,1,1,0,0,1,0,1,1,1,1,1,1,1,1,0,1,1,1,1,1,1,1,0,1,1,0,1,0],
[1,1,0,0,0,1,1,1,1,1,1,1,1,1,1,1,1,1,1,1,1,1,1,1,0,1,1,1,0,1],
],
"24711":[
[0,0,1,0,0,0,0,0,0,0,0,0,0,0,0,0,0,0,0,0,0,0,0,0,0,0,0,0,1,0],
[0,0,1,0,0,0,0,0,0,0,0,0,0,0,0,0,0,0,0,0,0,0,0,0,0,0,0,0,1,0],
[1,1,0,1,1,0,0,0,0,0,0,0,0,0,0,0,0,0,0,0,0,0,0,0,0,0,0,1,0,1],
[0,0,1,0,0,0,0,0,0,0,0,1,1,1,0,0,0,0,0,1,1,1,1,0,0,1,1,0,1,0],
[0,0,1,0,0,0,0,0,0,1,1,1,0,1,1,1,0,1,1,1,0,0,1,1,0,0,0,1,0,1],
[0,0,0,1,1,1,1,0,1,0,0,0,1,0,0,1,1,1,0,0,1,0,0,1,1,0,0,0,1,0],
[0,1,1,1,0,0,1,1,0,1,1,0,0,1,1,0,1,0,0,1,0,0,0,0,1,1,0,0,1,0],
[1,1,0,0,0,1,0,1,1,1,1,1,0,1,1,1,0,1,1,1,0,1,0,1,1,1,1,0,0,0],
[0,0,1,1,0,1,0,0,1,1,1,0,0,0,1,0,0,0,1,1,1,1,1,0,0,0,1,1,1,0],
[0,0,1,1,1,1,0,1,0,1,1,0,1,0,0,0,1,0,0,0,0,1,1,0,1,0,0,0,1,1],
[1,0,0,1,0,1,1,1,1,0,1,1,0,1,0,0,1,1,0,1,1,1,0,1,0,1,0,0,0,0],
[1,1,1,0,1,0,1,1,0,0,0,1,0,1,1,1,1,1,1,0,1,1,1,1,1,1,1,0,0,1],
[1,1,0,1,0,0,0,1,0,1,0,1,0,0,0,0,0,1,1,0,1,1,1,1,1,1,0,1,0,1],
[1,1,1,1,1,1,1,0,0,1,1,1,0,1,1,1,1,0,0,0,1,1,1,1,1,1,1,1,1,0],
[0,0,1,1,1,1,1,1,1,1,1,1,0,1,0,1,1,1,1,0,0,0,0,1,1,1,0,1,1,1],
[0,0,0,0,1,1,1,1,1,1,1,1,0,1,0,0,1,1,1,0,1,1,1,0,0,1,0,1,1,1],
[1,0,1,0,0,0,0,1,1,1,1,1,1,1,1,1,1,1,1,0,1,1,1,1,1,0,0,1,1,1],
[1,1,0,0,1,1,0,0,1,1,0,0,0,0,0,0,1,1,1,1,1,1,1,1,1,1,0,0,1,1],
[1,1,1,1,1,1,0,1,0,1,1,0,1,1,0,0,0,0,0,0,0,1,1,1,1,1,0,1,0,0],
[0,1,1,1,0,1,1,0,0,0,1,1,1,0,1,0,1,1,1,0,1,0,0,1,1,1,0,1,1,1],
[0,1,0,1,0,1,0,1,0,1,0,1,1,1,1,1,1,0,0,1,1,1,1,0,1,1,0,1,1,1],
[0,0,1,0,1,0,1,1,1,0,1,0,1,1,1,1,1,1,1,1,1,1,0,0,0,0,1,1,1,1],
[1,0,1,1,1,1,1,1,1,1,0,0,0,1,0,1,1,0,0,0,1,1,1,1,0,0,0,0,1,1],
[1,1,1,1,1,1,1,0,1,1,1,0,0,1,1,0,0,0,1,0,0,1,0,1,1,0,1,0,0,1],
[1,1,1,1,1,1,0,1,0,1,0,1,0,0,1,0,1,0,0,0,0,1,0,1,0,1,0,0,0,0],
[1,1,1,1,0,1,1,1,0,0,0,0,1,0,1,0,0,0,0,0,1,0,0,1,1,1,0,1,0,0],
[1,0,1,0,1,0,1,1,1,1,0,1,1,0,1,1,0,0,1,1,0,0,0,0,1,1,1,1,0,1],
[0,1,0,1,0,1,1,0,1,1,1,0,1,0,0,1,1,1,1,0,0,0,0,0,0,0,1,0,1,0],
[1,0,1,1,0,1,0,1,0,1,1,1,1,1,0,1,1,0,0,0,0,0,0,0,1,1,1,0,1,0],
[1,0,1,1,0,1,1,0,1,1,1,1,1,1,0,0,1,1,1,1,0,0,1,1,1,1,1,1,0,1],
],
"24712":[
[0,0,0,0,0,1,1,1,0,0,0,1,1,0,0,0,0,0,0,0,0,0,1,1,1,0,0,0,0,0],
[0,0,0,0,1,1,0,1,0,1,1,1,1,1,0,0,0,0,0,1,1,1,1,1,1,1,1,0,0,0],
[0,0,1,1,1,0,1,0,1,1,0,0,1,1,0,0,1,1,1,1,1,0,0,0,0,0,1,1,1,0],
[1,1,1,1,0,0,1,1,0,0,0,1,1,0,0,0,1,0,0,0,0,0,1,0,1,0,0,0,1,1],
[0,0,0,0,1,1,1,1,1,1,0,1,1,0,0,0,1,1,0,1,0,0,1,0,1,0,0,1,1,1],
[1,0,1,1,1,0,0,0,0,1,1,0,1,1,1,0,1,1,1,0,1,0,0,0,0,0,1,0,1,1],
[0,1,1,1,0,1,0,0,1,0,1,1,0,0,1,1,0,1,1,1,0,1,1,0,0,1,1,1,1,0],
[0,1,0,1,0,1,0,0,1,0,1,1,0,1,1,0,0,0,0,1,1,1,1,1,1,1,1,1,0,0],
[1,1,1,1,0,0,1,1,0,0,1,0,1,1,0,0,0,0,0,0,0,1,1,1,0,0,0,0,0,0],
[1,0,1,1,0,0,0,1,0,0,1,1,1,0,0,0,1,1,0,1,1,0,0,0,0,0,1,1,1,0],
[0,0,0,1,1,0,0,0,1,1,1,1,0,1,0,1,1,1,1,1,1,1,0,0,1,1,1,1,1,1],
[1,1,0,1,1,1,1,1,1,1,0,0,0,1,0,1,1,1,1,0,1,1,0,0,1,1,0,0,0,1],
[0,1,1,0,1,0,0,0,0,0,1,1,1,1,0,0,1,1,1,1,1,0,0,0,1,0,1,1,1,1],
[0,0,1,0,0,1,1,1,0,0,1,1,1,0,0,0,0,1,1,1,0,0,0,0,0,1,1,1,1,0],
[0,0,1,0,1,1,1,1,1,0,1,1,0,0,0,0,0,0,1,0,0,0,0,0,0,0,0,0,0,0],
[0,0,1,1,1,1,0,0,1,1,1,0,1,1,1,0,0,0,1,1,1,0,0,0,1,1,1,1,1,0],
[0,0,0,1,1,0,0,0,0,1,0,1,0,0,1,1,1,1,1,0,0,1,0,1,1,0,0,1,1,1],
[0,1,1,1,1,0,0,0,0,0,1,1,0,1,0,0,0,0,0,1,0,1,0,1,1,0,1,0,1,1],
[1,1,0,0,1,1,1,0,0,1,1,1,1,0,0,1,0,1,0,0,1,1,1,1,1,1,1,1,1,1],
[1,1,1,1,0,0,1,0,1,1,0,0,1,0,0,1,0,1,0,0,1,0,0,1,0,0,1,1,1,0],
[1,1,1,0,1,1,1,0,1,1,0,0,1,0,0,0,0,0,0,0,1,0,0,1,0,0,0,0,0,0],
[0,0,1,1,1,1,0,0,0,1,1,0,1,1,0,0,0,0,0,1,1,0,1,1,0,0,0,0,0,0],
[0,0,0,0,0,0,0,0,1,1,1,1,0,1,1,1,1,1,1,1,0,1,1,0,0,0,0,0,0,0],
[0,0,0,1,1,1,1,1,1,0,1,1,0,0,1,1,1,1,0,0,0,1,1,1,1,1,1,0,0,0],
[0,1,1,1,0,0,0,0,0,1,0,1,1,0,1,1,0,1,1,0,1,1,0,0,0,0,1,1,1,0],
[1,1,0,1,1,1,0,0,1,1,1,1,1,0,1,0,1,0,1,0,1,1,0,1,0,1,1,1,1,1],
[0,0,1,0,1,0,1,1,1,0,1,1,1,0,1,1,0,0,1,0,1,1,1,0,1,1,0,1,0,0],
[1,0,1,1,0,1,1,1,1,1,1,1,0,1,1,0,1,0,0,0,0,1,1,1,0,0,1,0,1,1],
[1,1,1,1,0,1,0,1,1,1,1,1,0,0,0,0,1,0,0,0,0,1,1,1,1,1,0,1,1,1],
[1,1,0,0,1,0,1,1,1,1,1,1,1,1,1,1,1,1,1,1,1,1,1,1,1,1,1,1,1,1],
],
}