{"26701":[
[0,0,0,0,0,0,0,1,1,1,0,1,1,1,1,1,1,1,1,1,1,1,0,0,0],
[0,0,0,0,0,1,1,0,0,0,1,0,0,0,0,0,1,1,1,1,1,0,0,0,0],
[0,0,0,0,1,0,0,1,1,0,0,0,0,0,1,0,0,0,0,1,1,1,1,0,0],
[0,0,0,1,0,0,1,1,0,1,0,1,1,0,1,0,0,1,1,0,1,1,1,1,1],
[0,0,0,1,0,1,1,0,1,1,1,1,1,0,0,1,0,0,1,1,0,1,1,1,1],
[0,0,0,1,0,1,1,0,1,1,0,0,1,1,0,1,1,0,0,1,0,1,1,1,0],
[0,0,0,0,1,1,0,1,1,0,0,0,0,1,0,0,1,1,0,1,0,1,1,0,0],
[0,0,0,0,1,0,0,1,1,0,0,0,0,1,1,1,0,0,1,0,1,1,0,0,0],
[0,0,0,1,0,0,1,0,0,0,0,0,0,0,0,1,1,0,1,0,1,1,1,1,0],
[0,0,1,0,1,0,1,0,1,0,0,0,0,0,1,0,1,0,1,1,0,1,1,1,1],
[0,0,1,0,1,0,1,0,1,0,0,1,0,0,1,0,1,0,0,1,1,0,1,1,0],
[0,0,1,0,1,0,1,0,0,0,0,0,0,0,0,0,1,0,1,1,1,0,1,0,0],
[0,0,0,1,0,1,0,1,0,0,1,1,1,0,0,1,0,0,1,0,1,0,1,0,0],
[0,0,0,1,0,1,0,1,1,0,0,0,0,0,1,1,0,1,0,0,1,1,1,1,0],
[0,0,1,0,1,0,1,0,1,1,0,0,0,1,1,0,0,1,0,1,0,1,1,1,1],
[0,1,0,0,1,0,1,1,0,1,1,1,1,1,0,1,1,0,0,1,0,0,1,1,1],
[0,1,0,1,1,0,1,1,0,1,1,0,0,1,0,1,1,0,1,1,1,0,0,1,1],
[0,1,0,1,1,1,0,1,0,1,1,0,0,1,0,0,1,0,0,1,0,1,1,0,1],
[0,0,1,0,1,0,1,0,1,1,0,0,0,0,1,0,0,1,0,1,0,1,1,0,1],
[0,0,1,0,0,1,0,1,1,1,1,1,1,1,1,1,0,1,0,0,0,1,0,0,1],
[0,1,0,1,0,1,0,1,1,1,1,1,1,1,1,1,0,1,0,0,1,0,0,1,1],
[1,0,0,1,0,1,0,0,1,1,0,0,0,1,1,0,1,1,1,0,1,0,1,1,1],
[1,0,1,1,1,0,1,1,0,1,1,0,1,1,0,1,1,0,1,0,1,0,1,1,1],
[1,0,1,1,0,1,0,1,0,1,0,1,1,1,0,1,1,0,0,1,0,1,0,1,1],
[0,1,0,1,1,0,1,0,1,1,1,0,0,1,1,0,1,1,0,0,1,1,0,0,1],
],
"26702":[
[0,0,1,1,0,1,0,1,0,1,1,0,0,0,1,0,1,1,0,0,1,1,0,0,0],
[0,0,1,0,1,0,1,0,1,0,1,1,1,0,0,1,0,0,1,0,0,1,1,0,0],
[0,1,1,0,1,0,1,0,1,0,0,1,0,1,0,1,1,0,0,1,0,1,1,0,0],
[0,1,0,0,0,1,0,1,0,1,0,0,1,1,1,0,1,1,0,1,1,0,1,1,0],
[0,1,0,1,0,1,0,1,0,0,1,1,0,0,1,0,0,1,0,1,1,0,1,1,0],
[0,1,0,1,1,0,1,1,1,0,0,0,1,1,1,1,0,1,1,0,1,0,1,1,0],
[0,1,0,1,1,0,1,1,1,1,1,1,0,0,0,1,0,1,0,0,1,0,1,1,0],
[0,1,0,1,1,0,1,0,0,0,1,1,1,1,1,1,0,0,1,0,1,0,1,1,0],
[0,1,0,1,0,1,1,0,0,0,0,0,0,0,1,1,1,0,1,0,1,0,1,1,0],
[0,1,0,1,1,1,0,1,0,0,0,0,1,0,0,1,1,1,0,0,1,0,1,1,0],
[0,1,0,0,1,0,0,1,0,1,0,0,1,0,0,1,1,1,0,1,1,0,1,1,0],
[0,1,1,0,1,0,0,0,0,0,0,0,0,0,1,1,1,1,0,1,0,0,1,1,0],
[0,0,1,0,1,1,0,0,0,1,1,0,0,1,1,1,1,0,0,1,0,1,1,0,0],
[0,0,1,0,1,1,0,0,0,0,0,0,1,1,0,0,1,0,1,1,0,1,1,0,0],
[0,0,1,1,0,1,1,0,0,0,0,0,0,0,0,1,0,1,1,0,0,1,1,0,0],
[0,0,0,1,1,0,1,1,1,0,0,0,1,1,1,1,1,0,1,0,1,1,0,0,0],
[0,0,0,1,1,1,0,0,1,1,1,1,1,1,1,1,1,1,1,1,1,1,0,0,0],
[0,0,0,0,1,1,1,1,1,1,1,0,1,1,1,1,1,1,0,1,0,1,1,0,0],
[0,0,0,1,1,0,0,1,1,1,1,0,0,1,0,1,1,0,0,1,0,1,1,0,0],
[0,0,0,1,0,1,0,0,1,1,1,0,1,0,1,1,1,0,1,1,0,0,1,1,0],
[0,1,1,1,0,1,0,0,1,0,0,0,0,0,1,1,1,0,1,0,1,0,1,1,1],
[1,1,1,0,0,1,1,0,1,1,0,0,0,1,1,1,0,0,1,0,1,0,1,0,1],
[1,0,1,0,1,0,1,1,0,1,1,1,1,1,1,1,0,1,1,0,1,0,0,1,0],
[0,0,1,0,1,1,0,1,0,1,0,0,0,0,1,1,0,1,0,1,0,1,0,1,0],
[0,0,1,0,1,1,0,1,0,1,1,0,1,1,1,1,1,0,1,0,0,1,0,1,0],
],
"26703":[
[0,0,1,1,1,1,1,1,1,1,1,1,1,1,1,1,1,1,1,0,0,0,0,0,0],
[0,0,0,1,1,1,1,1,1,0,0,0,0,0,0,0,0,0,1,1,1,0,0,0,0],
[0,0,0,0,1,1,1,0,0,0,1,0,1,0,0,0,1,0,0,0,1,1,0,0,0],
[0,0,0,1,1,1,0,0,1,0,1,0,1,0,0,0,1,1,0,0,0,1,0,0,0],
[0,0,1,1,1,1,0,0,1,0,1,1,1,0,1,0,0,1,0,1,0,1,1,0,0],
[1,1,1,1,1,1,0,1,0,1,1,1,0,0,1,1,0,1,1,0,0,0,1,0,0],
[0,1,1,1,1,0,0,1,0,1,1,1,0,0,1,1,1,0,1,0,1,0,1,0,0],
[0,0,0,1,1,0,1,0,1,1,0,1,1,0,0,1,1,1,0,1,1,0,1,0,0],
[0,0,1,1,1,0,1,0,1,0,0,0,1,1,1,1,0,1,0,0,1,0,1,1,0],
[0,0,0,1,1,0,1,1,0,1,1,0,0,0,0,0,0,1,1,1,0,1,0,1,0],
[0,0,0,0,1,1,1,0,0,0,0,0,0,0,0,0,0,0,0,1,1,1,0,1,0],
[0,0,1,1,1,0,1,0,0,0,1,0,0,0,0,1,0,0,0,1,0,1,0,1,0],
[0,1,1,1,1,0,1,0,0,0,1,0,1,0,0,1,0,0,0,1,0,1,0,1,0],
[0,0,0,1,1,0,1,0,0,0,0,0,1,1,0,0,0,0,0,1,0,1,0,1,0],
[0,0,0,0,1,1,1,1,0,0,0,0,0,0,0,0,0,0,1,1,1,0,0,1,0],
[0,0,0,1,1,1,0,1,0,0,0,1,1,1,1,0,0,0,1,1,1,0,1,1,0],
[0,0,0,0,1,1,0,0,1,0,0,1,1,1,1,0,0,1,1,0,1,0,1,0,0],
[0,1,0,1,0,1,1,0,1,1,1,0,0,0,0,1,1,1,1,0,0,1,1,0,0],
[1,1,1,1,1,0,1,0,0,1,1,1,1,1,1,0,1,0,0,0,1,1,0,0,0],
[0,1,1,1,0,0,1,1,1,0,1,0,0,1,1,0,0,0,1,1,0,1,1,0,0],
[0,0,1,0,0,1,1,1,1,1,1,0,0,1,1,0,0,1,1,0,0,1,1,0,0],
[0,0,0,1,1,1,1,1,1,1,0,0,0,0,1,1,0,0,0,1,0,1,1,0,0],
[0,1,1,1,1,1,1,0,0,0,0,1,1,1,1,1,1,1,1,0,1,0,1,1,0],
[1,1,1,0,0,0,0,1,1,1,1,1,1,1,1,1,1,0,1,1,0,0,1,1,1],
[1,1,1,0,0,0,0,0,0,0,0,0,0,0,0,1,1,1,0,0,0,1,0,0,1],
],
"26704":[
[1,1,0,0,0,1,1,1,1,0,0,0,1,1,1,1,1,1,0,0,0,1,1,1,1,0,0,0,1,1],
[1,0,0,1,1,0,0,0,0,1,1,0,0,1,1,1,1,0,0,1,1,0,0,0,0,1,1,0,0,1],
[1,0,1,0,1,0,1,1,1,0,0,1,0,0,0,0,0,0,1,0,0,1,1,1,1,0,0,1,0,1],
[0,0,1,0,1,0,0,0,1,1,0,1,1,1,1,1,1,1,1,0,1,1,0,0,0,1,0,1,0,0],
[0,1,0,0,0,1,1,0,0,1,1,0,0,0,0,0,0,0,0,1,1,1,0,1,1,0,0,0,1,0],
[0,1,0,1,0,1,1,1,1,0,0,1,0,1,0,1,0,0,0,0,0,1,1,1,0,0,1,0,1,0],
[0,1,0,1,0,0,1,0,0,0,1,0,1,1,0,1,1,0,1,0,0,0,0,1,0,1,1,0,1,0],
[0,1,0,1,1,1,1,0,1,1,1,0,1,1,0,1,1,0,1,1,0,1,0,1,1,1,1,0,1,0],
[0,1,0,0,1,1,0,0,1,1,1,0,1,0,0,0,1,0,1,1,0,1,0,0,1,0,0,1,1,0],
[0,0,1,1,0,1,0,1,1,1,0,0,1,0,0,1,0,0,0,1,1,0,1,0,1,0,1,1,0,0],
[1,0,0,1,1,0,0,0,1,1,0,1,0,1,0,1,0,1,0,1,1,0,1,0,0,1,1,0,0,0],
[1,1,0,0,1,0,0,1,0,1,1,1,0,1,0,1,0,1,1,0,1,1,1,0,0,1,0,0,1,1],
[1,1,1,0,1,0,1,0,1,1,1,0,1,1,1,1,1,1,1,1,1,1,0,1,0,1,0,1,1,1],
[1,1,1,0,1,0,1,1,1,0,0,0,0,1,1,1,1,1,0,0,0,1,0,1,0,1,0,1,1,1],
[1,1,1,0,0,1,1,0,0,1,1,1,0,0,1,1,0,0,1,1,1,0,1,1,1,0,0,1,1,1],
[1,1,1,0,1,1,1,0,1,0,1,0,1,0,0,0,0,1,0,1,0,1,0,1,1,1,0,1,1,1],
[1,1,1,0,1,0,1,0,0,0,1,1,0,0,0,0,0,0,1,1,0,0,0,1,0,1,0,1,1,1],
[1,1,1,0,1,0,0,1,0,0,0,0,0,0,0,0,0,0,0,0,0,0,1,0,0,1,0,1,1,1],
[1,1,1,1,0,1,0,1,0,0,0,0,0,0,1,0,0,0,0,0,0,0,1,0,1,0,1,1,1,1],
[1,1,1,1,1,0,1,1,1,0,0,0,1,0,0,0,0,1,0,0,0,1,1,1,0,1,1,1,1,1],
[1,1,1,1,1,1,0,0,1,1,0,0,1,1,1,1,1,1,0,0,1,1,0,0,1,1,1,1,1,1],
[1,1,1,1,1,1,1,0,0,1,1,0,0,0,0,0,0,0,0,1,1,0,0,1,1,1,1,1,1,1],
[1,1,1,1,1,1,1,1,0,0,1,1,1,0,0,0,0,1,1,1,0,0,1,1,1,1,1,1,1,1],
[1,1,1,1,1,1,1,1,1,0,1,0,1,1,1,1,1,1,0,1,0,1,1,1,1,1,1,1,1,1],
[1,1,1,1,1,0,0,0,0,0,1,0,0,0,1,0,0,0,0,1,0,0,0,0,0,0,1,1,1,1],
[1,1,1,0,0,0,1,1,1,1,1,1,0,0,0,1,0,0,1,1,1,1,1,1,1,0,0,0,1,1],
[1,1,0,0,1,1,1,0,0,0,0,0,1,1,0,1,1,0,1,0,0,0,0,0,1,1,1,0,0,1],
[1,1,0,1,0,0,0,1,0,1,0,1,0,0,0,1,0,0,0,0,1,1,0,1,0,0,0,1,0,1],
[1,0,0,1,0,0,1,1,0,1,1,0,1,0,0,1,0,1,0,1,1,1,0,1,1,0,0,1,0,0],
[1,0,1,0,0,1,1,1,0,1,1,1,1,1,0,1,0,0,1,0,1,1,0,1,1,1,0,0,1,0],
],
"26705":[
[0,0,0,0,0,0,0,0,1,1,1,0,0,0,0,0,0,0,0,0,0,0,0,0,0,0,0,0,0,0],
[0,0,0,0,0,0,1,1,0,0,0,1,1,0,0,0,0,0,0,0,0,0,0,0,1,0,1,0,0,0],
[0,0,0,0,0,1,0,1,1,1,1,0,0,1,0,0,0,0,0,0,0,0,0,1,1,1,0,1,0,0],
[0,0,0,0,1,1,0,1,0,0,1,1,1,0,1,0,0,0,0,0,0,0,0,0,1,1,1,0,0,0],
[0,0,0,0,1,0,1,0,1,1,0,0,1,0,1,1,1,1,1,1,1,1,0,0,0,1,0,0,0,0],
[0,0,0,1,0,1,1,0,1,1,0,1,1,1,0,0,0,0,0,0,0,1,1,1,0,0,0,0,0,0],
[0,0,0,1,0,1,0,1,0,1,1,1,0,0,1,1,0,0,1,1,1,0,0,1,1,1,1,0,0,0],
[0,0,0,1,0,0,1,1,0,0,1,1,0,1,1,1,1,1,0,0,0,1,1,0,0,0,1,1,1,0],
[0,0,0,0,1,0,1,1,1,1,1,0,1,1,1,1,1,1,1,1,1,0,0,1,1,0,0,0,1,1],
[0,0,0,0,1,1,0,0,1,0,1,1,0,0,0,1,1,0,0,0,0,0,1,1,1,1,1,0,0,1],
[0,0,0,0,0,1,1,1,1,0,0,1,1,1,1,0,0,0,1,0,1,1,1,1,1,1,1,1,0,1],
[0,1,0,1,0,0,1,0,0,1,0,0,1,1,0,0,1,0,1,1,0,1,1,0,1,1,1,1,0,1],
[1,1,1,1,1,0,1,0,1,1,1,1,0,1,0,1,1,0,1,1,0,1,0,0,1,1,0,1,0,1],
[0,1,1,1,0,1,1,1,0,0,1,1,1,0,1,1,0,1,1,0,1,1,0,1,1,0,1,1,0,1],
[0,0,1,0,0,1,0,1,1,1,0,0,1,0,1,1,0,1,0,0,1,0,0,1,0,1,1,0,0,1],
[0,0,0,0,1,1,0,1,1,1,1,1,1,0,1,0,1,1,1,1,1,1,1,0,1,1,0,0,1,1],
[0,0,0,1,1,0,1,1,0,1,1,1,1,1,0,1,1,0,0,0,0,0,1,1,1,1,1,1,1,0],
[0,0,0,1,0,1,0,1,0,1,0,1,1,1,0,1,0,1,1,1,1,1,0,0,0,1,1,1,0,0],
[0,0,0,1,0,0,1,0,1,1,0,1,1,0,1,1,0,0,0,1,0,1,0,0,0,0,1,1,0,0],
[0,0,1,1,0,1,1,0,1,1,1,0,1,0,1,1,1,0,0,1,1,0,0,0,0,0,1,1,0,0],
[0,0,1,0,0,1,1,1,0,1,1,0,1,0,1,1,1,0,0,0,0,0,0,0,0,0,1,1,0,0],
[0,1,1,0,1,1,1,0,1,1,0,1,1,1,0,1,1,1,1,0,0,0,0,0,1,0,1,0,0,0],
[1,1,0,1,1,0,1,0,1,1,0,1,0,0,1,0,1,1,1,1,0,0,0,0,0,0,1,0,0,0],
[1,1,0,1,0,1,1,0,0,1,1,0,1,0,1,0,1,1,1,1,0,0,1,0,0,1,1,0,0,0],
[1,1,0,0,0,1,1,1,0,0,1,1,0,1,1,0,1,1,1,1,1,0,1,1,0,1,0,0,0,0],
[1,1,1,0,1,0,1,1,1,0,1,1,0,1,1,0,1,1,0,1,1,0,0,0,1,1,0,0,0,0],
[0,1,1,0,0,1,1,0,0,1,1,1,0,1,0,1,1,1,1,0,0,0,0,1,1,0,0,0,0,0],
[1,1,0,0,1,1,1,0,1,1,1,0,1,1,0,1,1,1,1,1,1,1,1,1,0,0,0,0,0,0],
[1,0,0,1,1,1,1,0,1,1,1,0,1,1,0,0,1,1,1,0,1,0,0,0,0,0,0,0,0,0],
[1,0,0,1,1,1,1,1,0,0,1,1,0,1,1,0,1,1,1,0,1,0,0,0,0,0,0,0,0,0],
],
"26706":[
[0,0,0,0,0,0,0,0,0,0,1,1,1,1,1,1,0,0,0,0,0,0,0,0,0,0,0,0,0,0],
[0,0,0,0,0,0,0,0,0,1,1,0,0,0,1,1,1,1,1,1,0,0,0,0,0,0,0,0,0,0],
[0,0,0,0,0,0,0,1,1,1,1,1,1,1,0,0,0,0,0,1,1,1,1,0,0,0,0,0,0,0],
[0,0,0,0,0,0,1,1,0,1,1,0,1,0,0,0,1,0,0,0,0,0,1,1,0,0,0,0,0,0],
[0,0,0,0,0,1,1,1,1,1,0,0,1,0,1,0,1,0,0,1,0,0,0,1,1,0,0,0,0,0],
[0,0,0,0,0,1,0,1,1,0,1,1,0,0,1,0,1,1,0,1,1,0,0,0,1,1,0,0,0,0],
[0,0,0,0,1,1,1,0,1,0,1,1,0,0,1,1,0,1,1,0,1,0,1,0,1,1,0,0,0,0],
[0,0,0,0,1,0,1,1,1,1,1,1,1,0,1,1,1,0,1,1,0,1,1,0,0,1,1,0,0,0],
[0,0,0,0,1,1,1,0,0,0,1,1,1,1,0,0,1,0,1,1,0,1,1,1,0,0,1,1,0,0],
[0,0,0,1,1,1,0,0,1,1,1,1,1,1,1,1,0,1,1,1,0,1,1,1,0,0,1,1,0,0],
[0,0,0,1,0,1,0,1,1,0,0,1,1,1,1,1,1,0,1,1,1,0,1,0,1,0,0,1,1,0],
[0,0,0,1,1,0,0,0,0,0,0,0,0,0,0,1,1,0,0,1,1,0,1,0,1,0,0,1,1,0],
[0,0,0,1,1,1,1,1,0,0,1,1,1,1,1,1,1,1,0,1,1,0,1,0,1,1,0,1,1,0],
[0,0,1,1,1,0,1,0,0,0,0,1,0,1,1,0,1,1,1,0,0,1,0,0,0,1,0,1,1,0],
[0,0,1,0,1,1,0,0,1,0,0,0,1,1,1,0,0,1,0,0,0,1,1,0,1,1,0,0,1,1],
[0,0,1,0,1,0,0,1,1,0,0,0,0,0,0,0,1,1,0,0,0,1,1,0,1,1,0,0,1,1],
[0,0,1,0,1,0,0,1,0,0,0,0,0,0,0,1,1,0,0,0,1,1,1,0,1,0,1,0,1,1],
[0,0,1,0,1,0,0,1,1,0,0,0,0,0,1,1,0,1,1,1,0,1,1,0,0,1,1,0,0,1],
[0,1,1,0,1,0,1,0,0,0,1,0,1,1,1,0,0,1,1,1,0,1,0,1,0,1,0,0,0,1],
[0,1,0,0,1,1,0,1,1,1,0,1,1,1,0,0,1,1,1,1,0,1,0,1,0,1,0,0,0,1],
[0,1,0,1,1,1,0,0,0,0,0,1,0,0,0,1,1,1,1,1,0,1,0,1,0,1,0,1,0,1],
[0,1,0,1,1,1,1,0,0,0,0,0,1,1,1,1,1,1,1,0,0,0,0,1,0,1,0,1,0,1],
[0,1,0,1,1,1,1,1,1,1,1,1,1,0,0,0,1,1,1,0,1,0,1,0,1,0,1,0,0,1],
[0,1,0,1,0,1,0,1,1,1,1,0,0,0,0,1,1,1,0,0,1,0,1,0,1,0,1,0,0,1],
[0,1,0,0,0,0,1,0,1,1,1,0,1,1,1,1,1,1,0,0,1,0,1,1,1,0,1,0,1,1],
[0,1,0,0,1,0,1,0,1,1,1,1,1,0,0,0,1,1,0,1,1,0,1,1,1,0,1,0,1,1],
[1,1,0,0,1,0,1,1,1,1,0,0,0,0,1,1,1,1,0,1,1,0,1,1,0,1,1,0,1,1],
[1,0,0,1,1,1,0,0,0,0,0,0,1,1,1,1,1,1,0,1,0,0,1,1,0,1,1,0,1,0],
[1,0,1,1,0,0,0,1,0,1,1,1,1,1,1,1,1,0,0,1,0,1,0,1,0,1,0,0,1,0],
[1,1,1,0,0,1,1,0,1,0,1,1,1,1,1,1,1,0,1,1,0,1,0,1,0,1,0,0,1,0],
],
"26707":[
[1,1,1,1,1,1,1,1,1,0,0,0,1,1,1,1,1,0,0,0,1,1,1,1,1],
[1,1,1,1,1,1,1,1,0,0,1,1,0,0,0,0,1,1,1,1,0,0,1,1,1],
[1,1,1,1,1,1,1,0,0,1,0,0,1,1,1,1,0,0,0,1,1,1,0,1,1],
[1,1,1,1,1,1,0,0,1,1,1,1,1,1,0,0,0,1,1,0,0,1,1,0,1],
[1,1,1,1,1,0,0,1,0,0,0,1,1,1,1,1,1,0,0,1,1,0,1,1,0],
[1,1,1,0,0,0,1,1,1,1,1,1,1,1,1,0,0,0,0,0,0,1,0,1,0],
[1,0,0,0,1,1,0,0,0,0,0,1,1,1,1,1,1,1,1,0,0,1,0,1,0],
[0,0,1,1,0,0,1,1,1,1,1,0,0,0,1,1,1,0,1,1,0,1,1,1,0],
[0,1,0,1,1,0,1,1,0,0,1,0,0,0,0,0,1,1,0,1,0,1,1,0,0],
[0,1,0,0,1,1,1,0,0,1,1,0,1,0,1,0,1,1,0,1,0,0,1,1,0],
[1,0,1,1,1,1,0,1,0,1,0,0,1,0,1,0,0,1,1,0,1,0,1,1,0],
[1,1,0,0,1,0,1,0,0,1,0,0,1,1,1,1,0,1,1,0,0,0,0,1,1],
[1,0,1,1,1,0,1,0,1,1,0,1,1,0,1,1,0,1,1,0,1,0,0,1,1],
[1,1,0,1,1,0,1,0,1,1,1,0,0,0,1,0,0,1,0,1,0,1,0,1,1],
[1,0,0,1,1,0,1,1,0,0,0,0,0,0,0,1,0,1,0,1,0,1,0,0,1],
[1,0,1,0,1,1,1,0,1,0,0,0,0,1,0,0,1,1,0,1,0,1,1,0,1],
[0,1,1,0,0,1,1,0,1,0,0,1,0,1,0,0,1,1,1,0,0,1,0,1,0],
[0,0,1,0,1,0,1,0,0,0,1,1,0,0,0,1,1,1,1,0,1,0,0,0,0],
[1,0,0,1,1,0,1,1,0,0,0,0,0,0,0,1,0,1,0,0,1,0,1,1,1],
[1,1,0,0,0,1,0,0,0,1,1,1,0,0,0,1,0,0,1,0,1,0,1,1,1],
[1,1,1,1,0,1,1,0,0,1,1,0,0,0,1,1,0,0,0,1,0,0,1,1,1],
[1,1,1,1,0,1,1,1,1,0,0,0,1,1,1,0,1,1,0,0,0,1,1,1,1],
[1,1,1,1,0,1,1,0,1,1,1,1,1,0,0,1,1,1,1,1,1,1,1,1,1],
[1,1,1,0,0,1,1,0,0,0,1,1,0,1,1,1,1,1,1,1,1,1,1,1,1],
[1,1,1,0,1,1,1,1,0,0,0,1,0,1,1,1,1,1,1,1,1,1,1,1,1],
],
"26708":[
[1,1,1,1,1,1,1,1,1,1,1,1,1,1,1,1,1,1,1,1,1,0,1,0,1],
[1,0,1,1,1,1,1,1,0,0,0,0,0,1,1,1,1,1,1,1,0,1,0,1,0],
[0,1,0,1,1,1,0,0,0,1,0,0,0,0,0,0,1,1,1,0,1,1,1,1,1],
[1,0,1,1,0,0,0,0,1,1,0,0,1,0,1,0,0,0,1,1,0,1,1,1,0],
[1,1,1,1,0,1,0,1,1,0,1,0,1,1,0,1,1,0,1,1,1,0,1,0,1],
[1,1,1,1,0,1,0,1,0,1,1,0,1,1,0,1,1,1,0,1,1,1,0,1,1],
[1,1,1,0,1,0,1,1,0,1,0,1,1,1,1,0,1,0,0,1,1,1,1,1,1],
[1,1,1,0,1,0,1,0,0,1,0,1,0,1,1,0,1,1,0,1,0,1,1,1,1],
[1,1,1,0,1,0,1,1,1,1,1,1,0,0,1,0,1,0,1,0,1,0,1,1,1],
[1,1,0,1,1,1,1,0,0,0,0,0,0,0,0,1,1,1,0,0,1,0,0,1,1],
[1,1,0,1,1,0,0,1,0,0,0,0,1,0,0,1,1,0,1,0,1,0,0,0,1],
[1,1,1,0,1,0,0,1,0,1,0,0,1,0,0,1,0,0,1,0,1,1,1,0,0],
[1,1,1,0,1,1,0,0,0,1,1,0,0,0,0,1,0,1,1,0,1,0,0,1,0],
[0,1,1,1,1,1,0,0,0,0,0,0,0,0,0,1,1,1,0,1,1,1,1,0,1],
[0,0,1,1,1,1,0,0,0,1,1,0,0,0,1,0,0,0,1,1,1,0,0,1,1],
[0,0,0,0,1,1,1,0,0,0,0,0,0,1,1,1,1,1,0,1,0,1,0,0,1],
[0,1,0,1,0,1,1,1,0,0,0,0,1,1,0,0,0,1,0,1,1,0,1,1,0],
[1,1,1,1,1,0,1,1,1,1,1,1,1,0,0,0,0,1,0,1,1,0,0,1,0],
[0,1,1,1,0,1,1,1,1,0,1,1,0,0,0,0,0,0,1,0,0,1,1,0,0],
[0,0,1,0,1,1,1,1,1,0,1,1,0,0,0,0,0,0,0,1,1,0,0,0,0],
[0,0,0,1,1,1,1,1,0,0,1,1,1,1,1,1,1,0,0,0,0,0,0,0,0],
[0,1,1,1,1,1,0,0,0,0,0,0,1,1,1,0,1,1,1,1,0,0,0,0,0],
[1,1,0,0,1,1,1,1,1,1,1,1,1,1,0,0,0,0,0,1,1,0,0,0,0],
[0,0,0,1,0,0,0,0,1,1,1,1,0,0,0,0,1,1,0,0,1,1,0,0,0],
[0,0,0,1,1,1,0,0,0,0,0,0,0,0,1,1,1,1,1,0,0,1,0,0,0],
],
"26709":[
[0,0,0,0,0,0,0,0,1,1,1,1,1,1,1,1,1,1,1,1,1,1,1,1,1],
[0,0,0,0,0,0,1,1,1,0,0,0,0,0,0,0,0,1,1,1,1,1,1,0,1],
[0,0,0,0,0,1,1,0,0,0,1,0,1,0,1,0,0,0,0,0,1,1,0,1,0],
[0,0,0,0,0,1,0,0,1,0,1,0,1,0,0,1,0,0,0,0,0,1,1,0,1],
[0,0,0,0,1,1,0,1,1,1,0,1,0,1,0,1,1,0,1,0,0,1,1,1,1],
[0,0,0,0,1,0,0,1,0,1,0,1,0,1,0,1,1,0,1,0,1,0,1,1,1],
[0,0,0,0,1,0,0,1,0,1,1,0,1,1,1,0,1,1,0,1,0,0,1,1,1],
[0,0,0,0,1,0,1,1,1,0,1,0,1,1,1,0,1,1,0,1,0,0,1,1,1],
[0,0,0,0,1,0,1,0,1,1,1,1,1,1,1,1,1,1,0,1,0,0,0,1,1],
[0,0,0,0,1,0,1,0,0,0,0,0,0,1,1,1,1,0,1,0,0,1,0,1,1],
[0,0,0,0,1,1,0,1,0,0,0,0,1,0,0,1,1,0,1,0,0,1,0,1,1],
[0,0,0,0,0,1,0,1,0,1,0,0,1,0,0,1,1,0,1,0,1,0,0,1,1],
[0,0,0,0,0,1,0,0,0,0,0,0,0,0,1,1,1,0,1,0,1,0,0,1,1],
[0,0,0,0,0,1,0,0,1,1,1,0,0,1,1,1,0,1,0,1,1,1,1,1,1],
[0,0,1,0,0,1,1,0,0,1,1,0,1,1,0,0,1,0,1,1,1,1,1,1,1],
[1,1,1,1,1,0,1,1,0,0,0,0,0,0,1,1,0,1,1,1,1,1,1,1,1],
[0,1,1,1,0,0,1,1,1,1,1,1,1,1,1,1,0,0,1,1,1,1,1,1,1],
[0,1,0,1,0,0,1,0,1,1,0,0,0,0,0,0,0,1,0,0,1,0,0,1,1],
[0,0,0,0,1,1,1,0,1,1,1,0,0,1,1,1,1,1,1,1,0,1,1,0,1],
[0,0,0,1,1,0,1,1,1,0,1,1,1,1,1,1,1,1,1,1,1,0,0,1,0],
[0,0,0,1,0,0,0,1,1,0,1,1,1,0,0,1,1,1,1,1,0,0,0,0,1],
[0,0,1,1,0,1,0,0,0,0,0,0,0,0,1,0,1,1,1,1,0,0,1,0,1],
[0,0,1,0,0,1,0,1,0,1,0,0,0,1,0,1,1,1,1,0,0,0,1,0,1],
[0,0,1,0,1,1,0,1,1,0,1,1,0,0,1,0,1,1,1,0,1,1,1,0,1],
[1,0,1,1,1,1,0,1,1,1,1,1,0,0,0,1,1,1,1,0,0,1,1,0,1],
],
"26710":[
[0,0,0,0,1,1,1,0,0,0,0,0,0,0,0,0,0,0,0,0,0,0,1,1,1,0,0,0,0,0],
[0,0,0,1,0,0,0,1,1,1,0,0,0,0,0,0,0,0,0,1,1,1,0,0,0,1,0,0,0,0],
[0,0,1,0,1,1,1,0,0,0,1,1,1,1,0,1,1,1,1,0,0,0,1,1,1,0,1,0,0,0],
[0,0,1,0,1,1,0,1,1,1,0,0,0,0,1,0,0,0,1,1,1,0,0,1,1,0,1,0,0,0],
[0,0,1,0,1,1,1,1,1,1,1,1,1,0,1,0,1,1,1,1,1,1,1,1,1,1,0,1,0,0],
[0,1,0,1,1,1,0,1,0,1,1,0,0,0,0,1,0,0,1,1,0,0,1,1,0,1,0,1,0,0],
[0,1,0,1,1,1,0,1,0,0,1,1,1,0,0,0,0,1,1,0,0,1,0,1,0,1,0,1,0,0],
[0,1,0,1,0,1,0,1,1,1,0,0,0,0,0,1,0,0,1,1,1,1,0,1,1,0,0,0,1,0],
[0,1,0,1,0,1,0,1,1,0,1,0,1,0,0,1,1,0,0,1,1,1,0,1,1,0,0,0,1,0],
[0,1,0,1,0,1,1,0,1,0,1,0,1,0,1,1,1,1,0,1,1,0,0,1,1,0,0,0,1,0],
[0,1,0,0,0,1,1,1,0,1,1,0,1,0,1,1,1,1,1,0,1,1,0,1,0,0,1,0,1,0],
[0,1,0,0,1,1,1,1,0,1,0,1,0,1,1,0,1,1,1,0,1,0,0,1,0,0,1,0,1,0],
[0,1,0,1,1,1,1,0,1,0,0,1,1,0,0,1,0,1,1,1,0,0,1,1,1,0,1,0,1,0],
[0,1,0,1,1,1,0,1,0,1,1,1,0,0,0,0,0,0,1,1,0,1,1,1,1,0,1,0,1,0],
[1,1,0,1,1,1,1,1,1,1,0,0,1,0,0,0,1,0,1,1,1,0,1,0,1,1,1,0,1,0],
[1,0,0,0,1,1,1,0,1,0,0,0,1,0,1,0,1,0,1,1,1,0,1,0,1,1,1,0,0,1],
[1,0,0,0,1,0,1,1,1,0,0,0,0,0,0,0,0,0,1,0,1,1,0,0,0,1,0,0,0,1],
[1,0,1,0,1,0,1,0,1,1,0,0,0,1,1,1,0,0,0,1,1,1,1,0,1,1,0,1,0,1],
[1,0,1,0,1,0,1,0,1,1,0,0,0,1,1,9,0,0,0,1,1,0,1,0,1,1,1,1,0,1],
[1,0,1,1,1,0,1,0,0,1,1,0,0,0,0,0,0,0,1,1,0,0,1,0,1,1,1,1,0,1],
[1,0,1,1,0,1,1,0,0,0,1,1,1,0,0,0,1,1,1,0,0,0,1,0,0,1,0,1,0,1],
[1,0,1,0,0,1,0,0,0,0,0,1,0,1,1,1,1,1,0,0,0,0,0,1,0,1,0,1,0,1],
[0,0,1,0,0,1,0,0,0,0,0,1,0,1,1,1,1,1,0,0,0,0,0,1,0,1,0,1,0,0],
[0,1,1,1,0,1,0,0,0,0,1,1,0,0,0,0,1,1,0,0,0,0,0,1,0,1,0,0,1,0],
[0,1,0,1,0,1,0,1,1,1,1,0,0,0,0,1,1,1,1,1,1,1,0,1,0,0,1,0,1,1],
[1,1,0,1,0,1,1,1,0,1,0,1,1,0,0,0,1,1,1,1,0,0,1,1,0,0,1,0,1,1],
[1,1,0,1,0,1,0,0,0,1,0,0,0,0,0,0,0,0,1,1,0,1,1,1,0,0,1,1,0,1],
[1,0,1,0,1,1,0,1,0,0,1,1,1,1,1,1,1,1,1,0,0,0,1,1,1,0,1,1,0,1],
[1,0,1,0,1,1,1,0,1,0,0,0,0,0,0,0,0,0,0,1,1,0,1,1,1,0,0,1,0,1],
[0,1,1,0,1,1,1,1,1,1,1,0,0,0,1,1,1,1,1,1,1,1,1,1,1,0,0,1,0,1],
],
"26711":[
[0,0,0,1,1,1,1,1,1,0,0,0,0,0,0,0,0,0,0,0,0,1,1,1,1,1,1,0,0,0],
[0,0,1,1,0,0,0,1,1,1,0,0,0,0,0,0,0,0,0,0,1,1,1,0,0,0,1,1,1,0],
[0,1,1,0,1,1,1,0,0,1,1,1,1,1,1,1,1,1,1,1,1,0,0,1,1,1,0,0,1,0],
[0,1,0,0,0,0,1,1,1,1,1,0,0,0,0,0,0,0,0,1,1,0,1,1,1,0,0,1,1,0],
[0,1,1,1,1,0,0,1,1,0,0,1,1,1,0,1,1,1,0,0,0,1,1,0,0,1,1,1,0,0],
[0,0,1,0,0,1,1,1,0,1,1,1,1,1,1,1,1,1,1,0,0,0,1,1,1,0,0,1,0,0],
[0,0,1,1,1,1,1,1,0,1,0,1,0,1,1,1,1,1,0,1,1,0,1,1,1,1,1,1,1,0],
[0,1,1,0,0,1,1,0,1,0,1,0,1,0,1,0,1,1,0,1,1,0,0,1,1,0,0,0,1,0],
[0,1,0,0,1,0,1,0,1,0,1,1,1,0,0,1,0,1,1,0,1,1,0,1,0,1,1,1,1,0],
[0,0,1,1,0,1,1,0,1,1,0,1,1,1,0,1,0,0,1,0,0,1,0,1,1,0,1,1,1,0],
[0,1,0,0,1,1,1,0,1,0,1,1,0,1,1,1,1,1,1,1,0,1,0,1,0,1,1,0,1,1],
[1,1,1,1,1,0,1,0,0,1,0,0,0,0,1,1,0,0,0,0,1,1,0,1,1,1,1,1,1,1],
[1,0,0,0,1,1,1,1,1,0,1,1,1,1,0,0,1,1,1,1,0,1,1,1,1,1,0,0,0,1],
[1,1,1,1,0,0,1,0,1,0,0,1,0,1,0,0,1,0,1,0,0,1,0,1,0,0,1,1,1,1],
[0,1,1,0,1,1,1,0,1,0,0,0,1,1,0,0,1,1,0,0,0,1,0,1,1,1,0,1,1,0],
[0,0,1,1,0,1,1,1,0,1,0,0,0,0,0,0,0,0,0,0,1,0,1,1,1,0,1,1,0,0],
[0,1,1,0,1,1,0,1,1,1,0,0,0,1,0,0,1,0,0,0,1,1,1,0,1,1,0,1,1,0],
[0,1,1,0,1,0,0,0,0,1,1,0,0,1,1,1,1,0,0,1,1,0,0,0,0,1,0,1,1,0],
[0,0,1,1,0,1,0,0,0,0,1,1,1,0,0,0,0,1,1,1,0,0,0,0,1,0,1,1,0,0],
[0,0,0,1,1,1,0,0,0,0,0,0,1,1,1,1,1,1,0,0,0,0,0,0,1,1,1,0,0,0],
[0,0,0,0,0,0,0,0,0,0,0,0,0,1,0,0,1,0,0,0,0,0,0,0,0,0,0,0,0,0],
[0,0,0,0,0,0,0,0,0,0,0,1,1,1,0,0,1,1,1,0,0,0,0,0,0,0,0,0,0,0],
[0,0,0,0,0,0,0,1,1,1,1,1,0,0,1,1,1,0,1,1,1,1,1,0,0,0,0,0,0,0],
[0,0,0,0,1,1,1,1,0,1,0,1,0,1,1,1,0,0,1,1,1,0,1,1,1,1,0,0,0,0],
[0,0,0,1,1,0,1,0,0,1,0,1,0,1,0,1,0,1,1,1,1,0,0,1,0,1,1,0,0,0],
[0,0,0,1,1,1,1,0,0,1,0,0,1,0,0,0,1,1,0,1,1,0,0,1,1,1,1,0,0,0],
[0,0,1,1,1,1,1,0,0,1,1,0,0,0,1,1,0,0,1,1,1,0,0,1,1,1,1,1,0,0],
[0,0,1,0,1,0,1,0,1,0,1,1,0,1,0,1,1,1,1,1,0,1,0,1,1,1,0,1,0,0],
[0,0,1,0,1,1,1,0,1,1,0,1,1,1,1,1,1,1,1,0,1,1,0,1,0,1,0,1,0,0],
[0,0,1,1,1,1,1,0,1,1,1,0,0,0,0,0,0,0,1,1,1,1,0,1,1,0,0,1,0,0],
],
"26712":[
[1,0,0,1,1,1,1,1,1,1,1,1,1,1,1,1,1,1,1,1,1,1,1,1,0,0,0,1,1,1],
[0,1,0,0,1,1,1,1,0,0,0,0,0,0,1,1,1,1,1,1,1,1,1,0,0,1,1,0,1,1],
[1,0,0,1,1,0,0,0,1,0,0,1,1,0,0,0,0,1,1,1,1,1,0,0,1,1,1,1,1,1],
[1,1,1,1,0,0,1,1,0,1,1,1,0,1,1,0,0,0,1,1,1,1,0,0,1,1,1,1,1,1],
[1,1,1,1,0,1,1,1,1,1,1,0,1,0,0,0,0,0,1,1,1,1,0,0,1,1,1,1,1,1],
[1,1,1,0,0,1,1,0,1,1,1,1,1,1,0,0,1,0,1,1,1,1,1,0,0,1,1,0,1,1],
[1,1,1,0,1,1,1,0,1,0,1,1,1,0,0,1,1,1,1,1,1,1,1,1,0,0,0,1,1,1],
[1,1,1,0,1,0,1,0,0,1,0,1,1,0,0,1,0,1,1,1,0,0,1,1,1,1,1,1,1,1],
[1,1,1,0,1,0,1,1,0,1,0,1,1,0,1,0,0,1,1,0,0,1,0,1,1,1,1,1,1,1],
[1,1,1,0,0,0,1,1,0,1,0,0,1,0,1,0,0,1,1,1,0,0,1,1,1,1,1,1,1,1],
[1,1,1,0,0,1,0,1,0,1,1,0,1,0,1,0,0,1,1,1,1,1,1,1,1,0,0,1,1,1],
[1,1,1,1,0,1,0,1,0,1,1,0,1,0,1,0,0,1,1,1,1,1,1,0,0,0,1,0,0,1],
[1,1,1,1,0,0,1,0,0,1,1,0,1,0,1,0,1,1,1,1,1,1,0,0,0,1,0,1,1,0],
[1,1,1,1,0,0,1,0,1,1,0,0,1,0,1,1,1,1,1,1,1,1,1,0,0,0,0,0,0,1],
[1,1,1,1,0,1,1,0,1,1,0,1,1,0,1,1,1,1,1,1,1,1,1,1,1,1,1,1,1,1],
[1,1,1,1,0,0,1,0,1,0,0,1,1,0,1,1,1,1,1,1,1,1,1,1,1,1,1,1,1,1],
[1,1,1,0,0,1,1,0,1,0,0,0,1,0,0,1,0,0,0,1,1,1,1,1,1,1,1,1,1,1],
[1,1,1,0,1,1,1,0,1,0,0,0,1,1,0,1,0,1,0,0,1,1,1,1,1,1,1,1,1,1],
[1,1,1,0,1,1,0,0,1,0,1,0,0,1,0,1,1,0,1,0,1,1,1,1,1,1,1,1,1,1],
[1,1,1,0,1,1,0,1,0,0,1,0,0,1,0,1,1,1,1,0,0,1,1,1,1,1,0,0,1,1],
[1,1,1,0,0,1,0,1,0,0,1,0,1,0,1,0,1,1,0,1,0,1,1,1,1,0,0,0,0,1],
[1,1,0,0,0,1,0,1,0,1,1,0,1,0,1,0,1,1,1,0,0,1,1,1,0,0,1,0,1,0],
[1,1,0,1,0,1,0,1,0,1,1,0,1,0,1,1,1,1,1,0,0,1,1,1,1,0,0,0,0,1],
[1,1,0,1,1,0,0,1,0,1,0,0,1,1,1,1,0,1,1,1,0,0,1,1,1,1,1,1,1,1],
[1,0,0,1,1,0,1,1,0,0,1,0,1,1,1,1,0,1,1,1,1,0,1,1,1,1,1,1,1,1],
[1,0,1,0,1,0,1,1,0,0,1,0,1,1,1,0,0,1,1,0,0,0,1,1,1,1,1,1,1,1],
[1,0,1,0,1,0,1,1,0,0,1,0,1,1,0,1,0,1,0,1,1,1,1,1,1,1,0,0,1,1],
[1,0,1,0,1,0,0,1,0,1,1,0,1,1,1,0,0,1,1,0,0,1,1,1,1,0,1,0,0,1],
[1,0,0,0,1,0,0,1,0,1,1,0,1,1,1,0,0,0,1,0,0,1,1,1,1,1,0,0,1,1],
[1,0,0,1,1,0,1,1,0,0,1,1,0,1,1,1,0,0,1,0,0,1,1,1,1,1,1,1,1,1],
],
}