{

"701":[
[0,1,1,1,0,0,1,1,1,0],
[1,0,0,1,0,0,1,0,0,1],
[1,0,0,1,1,1,1,0,0,1],
[1,0,0,0,1,1,0,0,0,1],
[1,0,1,0,1,1,0,1,0,1],
[1,0,1,0,1,1,0,1,0,1],
[0,1,1,0,1,1,0,1,1,0],
[0,0,0,0,1,1,0,0,0,0],
[0,0,0,1,1,1,1,0,0,0],
[0,0,1,1,0,0,1,1,0,0],


],
"702":[
[1,0,1,0,0,0,1,0,0,0],
[1,1,1,1,0,1,1,1,0,0],
[0,1,0,1,1,1,0,1,0,0],
[0,1,0,0,1,0,0,1,0,0],
[0,1,0,0,1,0,0,1,0,0],
[0,1,0,0,1,0,0,1,0,0],
[0,1,0,0,1,0,0,1,0,0],
[0,1,1,0,1,1,0,1,1,0],
[0,0,1,0,0,1,0,0,1,0],
[0,0,1,1,0,1,1,0,0,1],


],
"703":[
[1,0,0,0,1,0,0,0,0,0],
[1,1,0,1,1,1,0,0,0,0],
[1,1,1,1,0,1,1,0,1,0],
[1,0,1,1,0,0,1,1,0,1],
[1,0,0,1,0,0,1,0,0,1],
[1,0,0,1,0,0,1,0,0,1],
[1,0,0,1,0,0,1,0,0,1],
[1,0,0,1,0,0,1,0,1,1],
[0,1,0,1,1,0,0,1,1,0],
[0,1,0,0,1,0,1,0,1,1],


],
"704":[
[1,0,0,0,0,0,0,0,0,0],
[1,1,0,1,0,0,0,0,0,0],
[0,1,1,1,1,0,0,0,0,0],
[0,1,0,0,1,0,0,0,0,0],
[0,1,0,0,1,0,0,1,1,0],
[0,1,0,0,1,0,1,1,1,1],
[0,1,0,0,1,1,1,0,0,1],
[0,1,0,0,0,1,1,0,0,1],
[0,0,0,0,1,1,1,1,1,1],
[0,0,1,1,1,0,0,1,1,0],


],
"705":[
[1,1,0,0,0,0,0,0,1,1],
[0,1,1,1,0,0,1,1,1,0],
[0,0,1,1,1,1,1,1,0,0],
[0,0,1,0,0,0,0,1,0,0],
[0,0,1,0,0,0,0,1,0,0],
[0,0,1,0,0,0,0,1,0,0],
[0,0,1,0,0,0,0,1,0,0],
[0,0,1,1,1,1,1,1,0,0],
[0,1,1,1,0,0,1,1,1,0],
[1,1,0,0,0,0,0,0,1,1],


],
"706":[
[0,0,0,0,1,1,1,1,1,1],
[0,0,0,0,1,0,0,0,1,1],
[1,0,0,0,1,1,0,1,0,1],
[1,1,0,0,0,0,1,0,0,1],
[1,1,1,0,0,1,0,1,0,1],
[0,1,1,1,1,0,0,1,1,1],
[0,0,0,1,1,0,0,0,0,0],
[0,1,1,0,1,1,0,0,0,0],
[1,1,1,0,1,1,1,0,0,0],
[0,1,0,0,0,1,1,1,0,0],
],
"707":[
[0,0,0,0,0,1,1,1,1,0,0,0,1,0,0],
[0,0,0,0,1,1,0,0,0,1,0,1,0,0,1],
[0,0,0,1,1,0,0,0,0,0,1,1,1,1,0],
[0,0,1,1,1,1,1,1,1,1,1,1,1,0,0],
[0,1,1,1,0,0,0,0,0,0,0,1,1,1,0],
[1,1,0,0,0,1,1,0,1,1,0,0,0,1,1],
[1,0,0,0,1,1,1,1,1,1,1,0,0,0,1],
[1,1,0,1,1,0,0,1,0,0,1,1,0,1,1],
[1,1,0,1,0,0,0,0,0,0,0,1,0,1,1],
[1,1,1,1,0,1,0,0,0,1,0,1,1,1,1],
[0,1,1,1,0,1,0,0,0,1,0,1,1,1,0],
[0,0,1,1,0,0,0,0,0,0,0,1,1,0,0],
[0,0,0,1,0,0,0,1,0,0,0,1,0,0,0],
[0,0,0,1,1,0,0,0,0,0,1,1,0,0,0],
[0,0,0,0,1,1,0,0,0,1,1,0,0,0,0],


],
"708":[
[0,0,0,0,0,0,0,0,0,1,1,1,1,1,0],
[0,0,0,0,0,0,0,0,1,1,0,0,0,1,1],
[0,0,0,0,0,0,0,0,1,0,0,1,0,0,1],
[0,1,1,1,1,1,0,0,1,0,1,1,1,0,1],
[1,1,0,0,0,1,1,0,1,1,1,0,1,1,1],
[1,0,0,1,0,0,1,0,1,1,0,0,0,1,1],
[1,0,1,1,1,0,1,0,1,1,0,0,0,1,1],
[1,1,1,0,1,1,1,0,1,0,0,0,0,0,1],
[1,1,0,0,0,1,1,0,1,0,0,0,0,0,1],
[1,1,0,0,0,1,1,0,1,1,0,0,0,1,1],
[1,0,0,0,0,0,1,0,1,1,1,1,1,1,1],
[1,0,0,0,0,0,1,0,0,1,1,1,1,1,0],
[1,1,0,0,0,1,1,0,0,0,0,0,0,0,0],
[1,1,1,1,1,1,1,0,0,0,0,0,0,0,0],
[0,1,1,1,1,1,0,0,0,0,0,0,0,0,0],


],
"709":[
[0,0,0,0,0,0,0,0,0,0,1,1,1,0,0],
[0,0,0,0,0,0,0,0,1,1,0,1,0,1,1],
[0,0,0,0,0,0,1,1,1,0,1,0,1,0,1],
[0,0,0,0,1,1,0,0,0,1,0,1,0,0,1],
[0,0,1,1,1,0,1,0,1,0,0,0,1,1,1],
[0,1,1,0,0,1,0,1,0,0,1,1,1,1,1],
[1,1,0,0,1,0,1,0,0,1,1,0,0,1,1],
[1,0,0,1,0,1,0,0,1,1,0,0,1,1,1],
[1,0,1,0,1,0,0,1,1,0,1,0,1,1,0],
[1,1,0,0,0,0,1,1,0,1,0,1,1,0,0],
[1,1,1,0,1,1,1,0,0,0,1,1,0,0,1],
[1,1,1,1,1,0,1,0,1,1,1,0,0,1,1],
[1,1,0,0,0,0,0,1,1,1,1,1,1,0,0],
[0,1,1,0,0,1,1,1,1,0,0,0,0,1,1],
[0,0,1,1,1,1,1,0,0,1,1,1,1,0,0],


],
"710":[
[0,1,0,1,0,1,0,1,0,0,0,0,1,0,0],
[0,1,0,1,0,1,0,0,0,0,0,1,1,0,1],
[0,1,0,0,0,0,1,1,1,0,1,1,0,1,0],
[0,1,0,0,1,1,0,0,0,1,1,0,1,0,0],
[0,0,0,1,1,0,0,0,1,1,0,1,0,0,0],
[0,0,1,1,0,0,0,1,1,0,1,0,1,0,0],
[0,1,1,1,1,1,1,1,1,1,1,1,1,1,0],
[1,1,0,0,0,0,0,0,0,0,0,0,0,1,1],
[1,0,1,1,1,1,1,1,1,1,1,1,1,0,1],
[1,0,0,0,0,0,0,0,0,0,0,0,0,0,1],
[1,1,0,1,1,1,1,1,1,1,1,1,0,1,1],
[0,1,1,0,0,0,0,0,0,0,0,0,1,1,0],
[0,0,1,1,0,0,0,0,0,0,0,1,1,0,0],
[0,0,0,1,1,1,1,1,1,1,1,1,0,0,0],
[0,0,0,0,1,1,1,1,1,1,1,0,0,0,0],


],
"711":[
[1,1,0,0,0,0,0,0,0,0,0,0,0,1,1],
[0,1,1,1,1,0,1,1,1,0,1,1,1,1,0],
[0,0,0,1,1,1,1,0,1,1,1,1,0,0,0],
[0,0,1,1,1,1,1,0,1,1,1,1,1,0,0],
[0,0,0,1,1,0,1,0,1,0,1,1,0,0,0],
[0,0,0,1,1,0,1,0,1,0,1,1,0,0,0],
[0,1,1,1,1,1,1,0,1,1,1,1,1,1,0],
[0,0,0,1,1,0,1,1,1,0,1,1,0,0,0],
[0,0,0,1,1,0,0,0,0,0,1,1,0,0,0],
[0,0,0,1,1,0,0,0,0,0,1,1,0,0,0],
[1,0,0,1,1,0,0,1,0,0,1,1,0,0,1],
[1,1,0,1,1,0,1,1,1,0,1,1,0,1,1],
[1,0,0,1,1,0,0,1,0,0,1,1,0,0,1],
[0,0,1,1,1,1,0,0,0,1,1,1,1,0,0],
[0,1,1,1,1,1,1,0,1,1,1,1,1,1,0],


],
"712":[
[0,0,1,1,0,1,1,0,0,0,1,1,1,0,0],
[1,1,0,0,1,0,0,1,0,1,0,0,1,1,0],
[1,0,0,0,1,1,1,1,0,1,1,0,0,0,1],
[1,1,1,1,1,0,0,0,0,0,1,1,1,1,1],
[0,0,0,0,0,0,1,1,1,0,0,0,0,0,0],
[1,1,1,1,0,1,1,0,1,1,0,1,1,1,1],
[0,0,1,1,0,1,0,0,0,1,0,0,1,0,0],
[1,1,0,0,1,0,0,0,1,0,1,0,0,1,1],
[0,0,0,1,0,1,0,1,0,1,0,1,0,0,0],
[0,0,1,1,1,0,1,0,1,0,1,1,1,0,0],
[0,1,1,1,1,1,1,1,1,1,1,1,1,1,0],
[1,1,1,0,1,1,1,1,1,1,1,0,1,1,1],
[1,1,0,1,1,1,1,1,1,1,1,1,0,1,1],
[0,0,0,0,1,1,0,1,0,1,1,0,0,0,1],
[0,0,1,1,0,1,1,0,1,1,0,1,1,0,0],


],
}