{"9401":[
[0,0,0,0,0,0,0,0,0,0,0,0,0,0,0,0,0,1,1,1,1,1,1,0,0],
[0,0,0,1,1,1,1,1,1,1,1,0,0,0,0,0,1,1,0,0,0,0,1,0,0],
[0,0,1,1,0,0,0,0,0,0,1,1,0,0,0,1,1,0,0,1,1,0,1,0,0],
[0,0,1,0,0,1,0,1,1,0,0,1,1,0,0,1,0,0,1,1,0,1,1,1,1],
[0,1,1,0,1,0,0,1,1,1,0,0,1,0,0,1,0,1,1,0,0,1,0,0,1],
[0,1,0,0,1,1,0,0,0,1,0,0,1,0,0,1,0,1,0,0,1,1,1,0,1],
[0,1,0,0,1,1,0,0,0,1,0,0,1,0,0,1,1,0,0,1,1,0,0,0,1],
[0,1,1,0,0,1,1,0,1,1,0,0,1,0,0,0,1,1,1,1,0,1,1,1,1],
[1,1,1,1,1,0,0,0,1,0,0,0,1,1,0,1,1,1,1,1,1,1,1,0,0],
[1,1,0,1,1,0,0,1,1,0,0,1,1,1,1,1,0,0,1,0,0,1,1,1,0],
[1,0,0,0,1,1,1,1,0,0,1,1,0,1,1,0,1,0,0,1,0,0,0,1,1],
[0,1,0,0,0,1,0,0,1,1,1,0,0,1,0,1,1,0,0,0,1,0,0,0,1],
[0,1,0,0,0,1,1,1,1,1,1,1,1,1,0,1,1,0,0,0,1,0,1,0,1],
[0,0,1,0,0,1,1,1,0,1,1,1,1,0,0,1,0,0,0,1,1,0,1,0,1],
[1,0,1,0,0,1,0,0,1,1,1,1,1,0,0,1,1,0,0,1,1,0,1,0,1],
[1,0,0,0,1,1,0,1,1,1,0,0,1,1,0,1,1,0,0,0,1,0,0,0,1],
[1,1,1,0,1,0,0,1,1,0,0,1,1,1,0,0,1,0,0,1,0,0,0,1,1],
[0,0,1,1,1,0,0,1,1,0,1,0,0,1,1,0,0,0,0,1,0,0,0,1,0],
[0,0,1,0,0,0,0,0,1,0,1,0,0,0,1,1,1,0,1,0,0,1,1,1,0],
[1,0,1,0,0,1,1,0,1,0,1,1,0,0,1,1,1,1,1,1,1,1,1,0,1],
[1,0,1,1,0,0,1,0,1,0,1,1,0,0,1,1,0,1,1,1,1,1,0,0,1],
[1,0,0,1,1,1,0,0,1,1,1,1,0,0,1,0,0,0,0,1,1,0,0,0,1],
[1,1,0,0,0,1,1,1,1,1,0,1,0,1,0,0,0,0,1,1,0,0,0,1,1],
[1,1,1,0,0,0,0,0,0,1,1,0,0,0,0,0,1,1,1,0,0,0,1,1,1],
[1,1,1,1,1,1,0,1,0,0,1,1,1,1,1,1,1,0,0,1,1,1,1,1,1],
],
"9402":[
[0,0,0,0,0,0,0,0,0,0,0,0,0,1,1,1,1,1,1,1,1,1,1,1,1],
[0,0,0,0,0,0,0,0,0,0,0,0,0,1,0,0,0,1,1,1,0,0,0,0,1],
[0,0,0,0,0,0,0,0,1,1,1,1,1,1,0,0,1,1,0,0,0,1,0,1,1],
[0,0,0,0,0,1,1,1,1,0,0,0,1,1,1,1,0,1,0,0,1,0,0,1,0],
[0,0,0,1,1,1,0,0,0,1,0,0,0,0,0,1,1,0,0,1,1,0,0,1,0],
[0,0,1,1,0,0,0,0,1,0,1,1,1,0,0,0,1,1,1,1,0,0,1,1,0],
[0,0,1,0,0,1,0,0,0,1,0,1,1,1,1,0,1,1,0,0,0,1,1,0,0],
[0,1,1,0,1,1,0,1,0,1,0,0,0,1,1,1,1,1,1,1,1,1,1,0,0],
[0,1,0,0,1,0,1,0,1,0,0,1,1,1,1,1,0,0,0,0,0,0,1,1,0],
[0,1,0,1,0,0,1,0,0,1,1,1,1,0,0,0,0,1,0,0,0,0,0,1,1],
[1,1,0,1,1,1,0,1,1,1,1,0,0,0,0,0,1,1,1,0,1,0,0,1,1],
[1,1,0,0,1,1,1,1,1,1,0,1,0,1,0,1,0,1,1,1,0,1,0,0,1],
[1,1,1,0,0,0,1,1,1,0,0,1,1,0,0,1,1,1,1,0,0,1,1,0,1],
[0,1,1,1,1,1,0,0,1,0,0,1,1,1,1,1,1,1,1,1,1,1,1,0,1],
[0,0,0,1,1,1,1,1,1,0,1,1,1,0,0,0,0,0,0,1,1,1,0,0,1],
[0,0,1,0,0,0,1,1,1,1,1,0,0,0,1,0,1,0,0,0,0,1,1,0,1],
[0,1,1,0,0,1,1,1,1,0,0,0,1,1,0,1,1,0,1,1,0,0,1,1,1],
[1,1,0,0,1,1,0,1,0,1,0,0,0,0,1,0,1,0,1,1,0,0,1,1,1],
[1,0,0,1,1,0,0,1,0,0,1,1,0,0,1,1,1,0,0,0,1,0,1,1,1],
[0,1,0,0,0,0,1,1,0,1,1,1,1,0,0,0,0,1,1,1,0,0,1,0,0],
[0,0,1,1,1,1,1,1,0,0,1,1,0,1,1,0,1,1,1,0,0,0,1,0,0],
[0,0,1,0,0,1,1,1,1,0,0,0,1,1,1,0,1,1,0,0,0,1,0,0,0],
[0,1,0,1,1,1,0,0,1,1,0,0,0,0,1,1,0,0,0,1,1,1,1,1,0],
[0,1,0,0,0,0,0,1,1,1,1,1,1,0,0,0,0,1,1,1,1,1,1,1,0],
[0,1,1,1,1,1,1,0,0,0,0,1,1,1,1,1,1,1,1,1,1,1,0,0,0],
],
"9403":[
[0,0,0,0,0,0,0,0,0,0,0,0,0,0,0,0,1,1,1,1,1,1,1,1,1],
[0,0,0,0,0,0,0,0,0,0,0,0,0,0,0,0,1,0,0,0,1,1,1,0,1],
[0,0,0,0,0,1,1,1,1,1,1,1,1,1,0,0,1,0,1,1,1,1,0,0,1],
[0,0,0,1,1,1,0,1,0,0,0,0,0,1,1,1,1,1,0,1,0,0,1,0,1],
[0,0,1,1,0,0,0,0,1,1,1,1,0,0,0,1,0,1,1,1,0,1,0,1,1],
[0,0,1,0,1,1,0,1,1,0,0,1,1,1,1,1,1,0,0,1,1,1,0,1,0],
[0,1,1,0,1,1,0,1,1,0,0,1,1,1,1,0,1,1,0,0,1,1,1,1,0],
[0,1,0,0,0,1,1,1,0,0,1,1,0,1,1,1,1,1,1,0,0,0,1,1,0],
[0,1,1,0,0,0,1,1,0,0,1,1,0,0,1,1,0,0,1,0,0,1,0,1,0],
[0,1,0,1,1,0,1,1,1,1,0,0,0,0,1,1,0,0,1,0,1,0,1,1,0],
[1,1,0,1,1,1,1,1,1,1,0,0,1,1,1,0,0,1,1,1,1,1,1,1,1],
[1,0,0,0,0,1,1,1,1,1,1,1,1,1,0,0,1,1,0,1,1,1,0,0,1],
[1,0,1,1,1,1,1,1,1,0,0,0,1,1,1,1,1,1,1,0,0,1,0,0,1],
[1,1,0,0,0,1,1,1,1,1,0,0,0,1,1,0,0,1,1,0,0,0,1,0,1],
[1,0,0,1,1,1,1,1,0,1,1,0,0,1,0,0,1,0,1,0,0,1,1,0,1],
[1,0,1,1,1,0,1,1,0,0,1,1,1,1,1,0,0,1,0,1,1,1,1,0,1],
[1,0,1,1,1,0,1,1,0,0,1,1,1,1,1,1,1,1,1,1,1,1,0,1,1],
[1,1,0,0,1,0,0,1,1,0,0,1,0,0,1,1,0,1,1,1,0,1,0,1,0],
[0,1,0,0,1,1,1,1,1,1,1,0,0,1,0,1,0,0,1,1,1,0,0,1,0],
[0,1,1,1,1,1,0,1,1,0,1,1,0,0,1,0,1,0,1,1,0,0,1,1,0],
[0,0,1,1,1,0,0,1,0,0,1,1,1,1,1,1,0,1,1,0,1,1,1,0,0],
[0,0,0,0,1,1,1,1,0,1,0,1,1,0,1,1,1,0,0,0,1,1,1,1,1],
[0,0,0,0,1,1,1,1,1,0,1,0,0,0,0,0,0,1,1,1,1,1,1,1,1],
[0,0,1,1,1,1,1,1,1,1,1,1,1,1,1,1,1,1,1,1,1,1,1,1,0],
[0,0,1,1,1,1,1,1,1,1,1,1,1,1,1,1,1,1,1,1,1,1,0,0,0],
],
"9404":[
[0,0,0,0,0,0,0,0,0,0,0,0,1,1,1,1,1,1,1,1,1,0,0,0,0,0,0,0,0,0],
[0,0,0,0,0,0,0,0,0,1,1,1,1,0,0,1,0,0,1,0,1,1,1,0,0,0,0,0,0,0],
[0,0,0,0,0,0,0,1,1,1,0,0,1,0,0,1,0,0,1,0,0,1,1,1,0,0,0,0,0,0],
[0,1,1,1,1,0,0,1,0,0,1,0,0,1,0,0,1,0,1,0,1,1,0,1,1,0,0,0,0,0],
[1,1,0,0,1,0,0,1,1,0,0,1,1,1,1,1,1,1,1,1,1,0,0,0,1,0,0,0,0,0],
[1,0,1,0,1,1,0,0,1,1,1,1,1,0,0,0,0,0,0,1,1,1,0,1,1,0,0,0,0,0],
[1,0,1,0,0,1,1,1,1,1,1,1,1,1,1,1,1,1,0,0,0,1,1,0,1,1,0,0,0,0],
[1,1,0,1,0,0,1,0,1,1,1,1,1,1,1,1,1,1,1,0,0,0,1,0,0,1,0,0,0,0],
[0,1,0,0,0,1,0,1,0,1,0,1,0,1,0,0,0,0,1,1,0,0,1,1,1,1,0,0,0,0],
[0,1,1,1,1,0,1,1,1,1,1,1,1,0,0,1,1,0,1,1,1,0,1,0,0,1,1,0,0,0],
[0,0,0,1,1,0,0,0,0,0,1,1,0,1,1,0,0,1,1,1,1,0,1,1,0,0,1,0,0,0],
[0,0,0,0,1,0,1,1,1,1,1,0,0,1,1,1,1,1,1,1,1,0,0,1,1,1,1,0,0,0],
[0,0,0,0,1,1,0,0,0,0,0,1,1,1,0,0,1,1,0,1,1,0,0,1,0,0,1,0,0,0],
[0,0,0,0,0,1,1,1,1,1,1,1,0,0,0,0,0,1,0,1,1,0,0,1,0,1,1,0,0,0],
[0,0,0,0,0,0,0,0,0,0,0,0,0,0,0,0,0,1,0,1,1,0,0,1,1,1,0,0,0,0],
[0,0,0,0,0,0,0,0,0,0,0,0,0,0,0,0,0,1,0,1,1,0,1,1,0,1,0,0,0,0],
[0,0,0,0,0,0,0,0,0,0,0,0,0,0,0,0,1,1,0,1,1,0,1,0,1,1,0,0,0,0],
[0,0,0,0,0,0,0,0,0,0,0,0,0,0,0,1,1,0,1,1,0,0,1,1,1,0,0,0,0,0],
[0,0,0,0,0,0,0,0,0,0,0,0,0,1,1,1,0,1,1,1,0,0,1,0,0,0,0,0,0,0],
[0,0,0,0,0,0,0,0,0,0,0,0,1,1,0,0,1,1,1,0,0,1,1,0,0,1,1,1,1,0],
[0,0,0,0,0,0,0,0,0,0,0,0,1,0,1,1,1,0,0,1,1,1,0,0,1,1,0,0,1,1],
[0,0,0,0,0,0,0,0,0,0,0,1,1,0,1,1,0,1,1,1,0,0,0,0,1,0,1,0,0,1],
[0,0,0,0,0,0,0,0,0,0,0,1,0,1,1,0,1,1,0,0,0,0,0,0,1,1,0,0,1,1],
[0,0,0,0,0,0,0,0,0,0,0,1,0,1,1,0,1,1,0,0,0,0,0,1,1,1,1,1,0,1],
[0,0,0,0,0,0,0,0,0,0,0,1,0,1,1,0,0,1,1,0,0,1,1,1,0,1,0,0,0,1],
[0,0,0,0,0,0,0,0,0,0,0,1,1,0,1,1,0,0,1,1,1,1,0,0,0,1,1,1,1,1],
[0,1,1,1,1,1,0,0,0,0,0,0,1,0,0,1,1,1,0,0,0,0,0,0,1,1,0,0,0,0],
[0,1,1,1,1,1,1,1,1,1,1,1,1,1,0,0,1,1,1,1,1,0,0,1,1,0,0,1,1,1],
[0,0,0,0,1,1,1,1,1,1,1,1,1,1,1,1,0,0,0,0,0,1,1,1,1,1,1,1,1,1],
[0,0,0,0,0,0,0,0,0,1,1,1,1,1,1,1,1,1,1,1,1,1,1,1,1,1,1,1,1,0],
],
"9405":[
[1,1,1,1,1,1,1,0,0,0,0,1,1,1,1,1,1,1,1,0,0,0,0,0,0,0,0,0,0,0],
[1,1,1,1,1,1,0,0,0,1,1,1,0,0,1,1,0,0,1,1,1,1,1,0,0,0,0,0,0,0],
[1,1,1,1,1,0,0,1,1,1,0,0,0,0,0,0,1,1,0,0,0,0,1,1,1,0,0,0,0,0],
[1,1,1,1,1,0,1,1,0,0,1,1,0,0,0,1,0,1,1,1,1,1,0,0,1,1,1,0,0,0],
[1,1,1,1,0,0,1,0,0,0,0,0,1,1,1,0,0,1,0,1,1,1,1,1,0,0,1,1,0,0],
[1,1,1,1,0,1,1,1,1,1,1,0,0,0,0,1,1,0,0,0,1,0,0,1,1,0,0,1,1,0],
[1,1,1,1,0,1,0,0,1,1,1,1,1,1,1,1,1,1,1,0,0,1,1,0,1,1,0,0,1,0],
[1,1,1,1,0,1,0,1,0,0,1,1,1,1,1,1,1,1,1,1,0,0,0,1,0,1,1,0,1,1],
[1,1,1,1,0,1,0,0,1,1,1,1,0,0,0,0,1,1,1,1,1,1,0,0,1,1,1,0,0,1],
[1,1,1,0,0,1,1,1,1,0,0,0,0,0,0,0,0,0,1,1,1,1,0,0,1,0,1,0,0,1],
[1,1,0,0,1,1,0,0,0,0,1,1,0,0,0,0,0,0,0,1,0,1,1,0,0,1,1,0,0,1],
[1,1,0,1,1,0,0,0,1,1,0,0,1,1,1,0,0,0,0,1,1,0,1,0,0,1,1,1,0,1],
[1,0,0,1,0,0,0,1,0,1,1,1,0,1,0,1,0,0,0,0,1,0,1,1,1,1,0,1,0,1],
[1,0,1,1,0,0,1,0,1,0,1,0,1,1,1,0,1,0,0,0,1,0,1,1,1,1,1,0,0,1],
[0,0,1,0,0,0,1,0,1,1,0,0,1,0,1,1,1,0,0,0,1,0,1,1,0,1,1,0,1,1],
[0,1,1,0,0,1,0,1,0,1,0,1,1,1,0,0,1,0,0,0,1,0,1,1,0,0,1,0,1,0],
[0,1,0,0,0,1,1,1,1,0,1,1,0,1,1,1,0,0,0,0,1,0,1,1,1,1,0,0,1,0],
[0,1,0,0,0,1,0,1,1,0,1,1,1,0,1,1,0,0,0,0,1,1,0,1,1,0,0,1,1,0],
[1,1,0,0,1,1,0,1,0,1,1,1,0,1,0,1,0,0,0,1,1,1,0,1,1,1,1,1,0,0],
[1,0,0,0,1,0,1,1,0,1,0,1,1,0,1,0,0,0,0,1,1,1,0,1,1,1,1,1,1,1],
[1,0,0,0,1,0,1,0,1,0,1,0,1,0,1,0,0,0,0,1,1,0,0,1,1,1,1,1,1,1],
[1,0,0,0,0,1,1,1,0,1,1,0,1,1,0,0,0,0,1,1,1,0,1,1,1,1,1,1,1,0],
[1,0,0,0,0,0,1,0,1,0,1,1,0,0,0,0,0,1,1,0,1,0,1,0,0,0,0,0,0,0],
[1,1,0,0,0,0,0,1,1,1,0,0,0,0,0,0,1,1,0,1,0,1,1,0,0,0,0,0,0,0],
[0,1,1,1,0,0,0,0,0,0,0,0,0,0,1,1,1,1,1,0,0,1,0,0,0,0,0,0,0,0],
[0,1,0,1,1,1,0,0,0,0,0,1,1,1,1,1,1,0,0,0,1,1,1,1,0,0,0,0,0,0],
[0,0,1,0,0,1,1,1,1,1,1,1,0,1,0,1,0,0,1,1,1,1,1,1,1,0,0,0,0,0],
[0,1,1,1,1,0,0,0,1,1,1,0,1,0,0,0,1,1,1,1,1,1,1,1,1,1,0,0,0,0],
[0,1,1,1,1,1,1,1,0,0,0,0,0,1,1,1,1,1,1,1,1,1,1,1,1,1,0,0,0,0],
[0,0,1,1,1,1,1,1,1,1,1,1,1,1,1,1,1,1,1,1,1,1,1,1,1,0,0,0,0,0],
],
"9406":[
[0,1,1,0,0,0,0,0,0,0,1,1,1,1,1,0,0,0,0,0,0,0,0,0,0,0,0,0,0,0],
[1,0,1,1,0,0,0,1,1,1,1,0,0,0,1,1,0,0,0,0,0,0,0,0,0,0,0,0,0,0],
[1,1,1,1,0,0,0,1,0,0,0,1,1,1,0,1,0,0,0,1,1,1,1,1,1,1,1,1,1,0],
[1,1,1,0,0,0,1,1,1,1,1,0,1,1,1,1,1,1,1,1,0,0,0,0,0,0,1,0,1,0],
[0,1,1,0,0,1,1,0,0,1,1,1,1,0,0,0,0,0,0,0,1,1,1,1,0,1,0,0,1,0],
[0,0,1,1,0,1,0,1,1,1,0,0,0,1,1,1,1,1,1,1,1,0,0,1,1,1,0,1,1,0],
[0,0,0,0,0,1,0,0,1,0,0,1,1,1,1,1,0,0,0,1,1,0,0,1,1,0,0,1,0,0],
[1,1,1,1,1,1,0,1,1,0,1,1,1,0,0,0,1,1,1,1,1,1,1,1,1,0,1,1,0,0],
[1,0,0,0,1,1,1,0,0,1,1,1,0,1,1,1,0,0,1,1,1,1,1,1,1,0,1,0,0,0],
[1,1,0,0,0,1,0,1,1,1,1,0,1,1,1,0,1,1,1,0,1,0,0,0,1,0,1,1,1,1],
[0,1,1,0,0,1,0,1,1,1,1,1,0,1,1,1,0,0,1,0,1,1,0,0,1,1,0,1,0,1],
[0,0,1,0,1,0,1,1,1,0,0,0,0,0,0,1,1,1,1,0,0,1,1,0,0,1,1,0,0,1],
[0,0,1,1,1,0,1,1,0,1,1,1,0,0,0,0,0,0,1,1,0,0,0,0,0,0,0,0,1,1],
[0,0,0,1,1,0,1,0,1,1,0,0,0,0,0,0,0,0,0,1,1,1,1,1,0,0,0,1,1,0],
[0,0,0,1,0,1,1,0,0,0,0,0,1,1,1,1,0,0,0,0,0,0,0,0,1,1,1,1,0,0],
[0,0,0,1,0,1,0,0,0,1,1,1,1,0,0,0,0,0,1,1,1,1,1,1,1,0,0,0,0,0],
[0,0,0,1,0,1,0,0,1,1,0,0,0,1,1,1,1,1,1,0,1,0,1,1,1,0,0,0,0,0],
[0,0,0,1,0,0,0,0,1,0,1,1,1,1,0,0,0,0,1,1,0,1,0,1,1,0,1,0,0,0],
[0,0,0,1,0,0,0,0,0,1,1,0,0,0,0,0,0,0,0,1,1,1,0,0,1,0,1,1,1,0],
[0,0,0,1,0,0,0,0,0,1,1,0,0,0,0,0,0,0,0,1,1,0,0,1,0,0,1,1,1,1],
[0,0,0,1,0,0,0,0,1,1,1,0,0,0,1,1,1,1,1,0,0,0,0,0,0,0,1,1,1,1],
[0,0,0,1,1,0,0,0,1,1,1,1,1,1,1,0,0,1,1,0,0,0,0,1,0,0,0,1,1,1],
[0,0,0,0,1,0,0,0,1,1,1,1,1,0,0,1,1,1,0,0,0,0,0,1,1,0,0,0,0,0],
[0,0,0,0,1,0,0,0,0,1,1,1,0,0,1,1,0,0,0,0,0,1,1,1,1,0,0,0,0,0],
[0,0,0,0,1,1,0,0,0,0,0,1,1,1,1,1,0,0,0,0,1,1,1,1,1,0,1,0,0,0],
[0,0,1,0,0,1,1,1,0,0,0,0,1,1,1,0,0,0,0,0,1,1,1,1,0,0,1,1,0,0],
[0,0,1,1,0,0,0,1,1,1,1,1,1,1,0,0,0,0,0,0,0,1,1,0,0,0,1,1,1,0],
[0,1,1,1,0,0,0,0,0,0,1,1,0,1,1,0,0,0,1,0,0,0,0,0,0,0,1,1,1,1],
[1,1,1,1,0,0,1,1,1,0,1,1,0,1,1,1,1,0,1,1,1,0,0,1,0,0,1,1,1,1],
[1,1,1,0,1,1,1,1,1,0,0,1,1,0,0,1,1,0,1,1,1,1,0,1,1,1,0,1,1,1],
],
"9407":[
[0,0,0,0,0,0,0,1,1,1,1,1,1,1,1,0,0,0,0,0,0,0,0,0,0],
[0,0,0,0,1,1,1,1,0,0,0,0,0,1,1,1,1,1,1,0,0,0,0,0,0],
[0,0,0,1,1,0,0,0,0,0,1,1,0,0,0,1,0,0,1,1,1,0,0,0,0],
[0,1,1,1,0,0,1,1,0,0,0,0,1,0,0,0,1,0,0,0,1,1,0,0,0],
[0,1,0,1,0,0,1,0,1,1,1,0,0,1,0,0,1,1,1,0,0,1,0,0,0],
[0,1,0,1,0,0,0,1,1,1,0,0,1,0,0,0,1,1,0,1,0,1,0,0,0],
[0,1,0,1,1,0,1,0,1,0,1,1,1,1,0,0,1,1,1,0,0,1,1,0,0],
[0,1,0,1,1,0,0,1,0,0,1,0,1,0,0,0,1,1,0,1,0,0,1,0,0],
[1,1,0,1,1,0,0,0,0,1,0,1,1,0,0,1,1,0,1,0,0,0,1,1,0],
[1,0,1,0,1,1,1,1,0,0,0,0,0,0,0,1,1,1,0,1,1,0,1,1,0],
[1,0,1,1,1,1,1,1,1,1,1,1,1,1,1,1,1,1,1,0,0,1,0,1,1],
[1,0,0,1,0,1,1,1,0,0,0,0,0,1,1,1,1,1,1,1,1,1,0,1,1],
[1,0,0,0,1,1,0,0,1,1,1,1,1,0,0,0,0,1,1,1,1,0,0,0,1],
[1,1,1,1,1,0,0,1,1,1,0,0,0,0,1,0,0,0,0,1,1,1,1,0,1],
[1,1,1,0,0,0,1,1,1,0,0,0,0,0,1,1,1,0,1,0,1,1,1,0,1],
[1,1,0,0,1,1,1,1,0,0,1,1,0,0,1,1,0,1,1,0,1,1,1,0,1],
[1,0,0,1,0,1,0,1,0,0,1,0,0,1,1,0,1,1,0,0,0,1,1,0,1],
[1,0,0,0,1,0,1,1,0,1,0,1,0,1,1,1,0,0,0,0,0,1,1,0,1],
[1,1,0,1,1,1,1,1,0,1,1,1,1,0,0,0,1,0,1,0,0,1,1,0,1],
[1,1,1,0,1,0,1,1,0,0,1,1,0,0,1,1,1,1,1,0,1,1,0,0,1],
[1,1,1,1,0,1,1,1,1,0,0,0,1,0,0,0,1,1,0,0,1,1,0,0,1],
[1,1,1,1,0,0,0,1,1,0,0,0,1,1,1,0,1,0,0,1,1,0,0,1,1],
[0,0,1,1,1,1,0,0,1,1,0,0,0,0,0,0,0,0,1,1,0,1,1,1,1],
[0,0,0,0,1,1,1,1,0,0,1,1,0,0,0,0,1,1,1,1,1,1,1,0,0],
[0,0,0,0,0,0,1,1,1,1,1,1,1,1,1,1,1,1,1,1,1,0,0,0,0],
],
"9408":[
[0,1,1,0,0,0,0,0,0,0,0,0,0,0,0,0,0,0,1,1,1,1,1,1,1],
[0,0,1,1,1,1,0,0,0,0,0,0,0,0,0,0,0,1,1,0,0,0,0,0,1],
[1,1,0,0,0,1,0,0,0,0,0,0,0,0,0,0,1,1,0,1,1,1,1,1,1],
[0,1,1,1,1,1,1,1,1,1,0,0,0,0,0,0,1,0,1,1,0,0,0,0,0],
[0,0,1,1,1,0,0,0,0,1,1,1,0,1,1,1,1,1,1,0,0,0,0,0,0],
[0,1,1,0,0,0,1,1,0,0,0,1,1,1,1,0,0,1,1,1,1,0,0,0,0],
[0,1,0,0,0,1,0,1,0,1,0,0,1,0,0,1,0,0,0,0,1,1,0,0,0],
[1,1,0,1,0,1,1,0,1,1,1,0,1,0,0,0,1,1,1,0,0,1,0,0,0],
[1,0,0,0,1,0,1,1,1,1,1,1,1,0,1,1,1,1,0,0,0,1,0,0,0],
[1,0,1,1,0,1,1,1,1,1,1,1,1,1,1,1,1,1,1,1,0,1,1,0,0],
[1,0,1,0,1,0,0,1,1,1,1,1,0,0,0,0,1,1,1,0,1,0,1,0,0],
[1,0,0,1,1,1,1,1,1,0,0,0,0,1,1,0,0,1,0,1,0,0,1,0,0],
[1,1,0,0,1,1,1,1,0,0,1,1,1,1,0,1,0,1,1,0,1,0,1,0,0],
[0,1,0,1,1,1,1,1,0,0,1,0,1,1,1,1,0,0,1,1,0,1,1,0,0],
[0,1,1,1,0,0,0,1,0,1,0,1,0,1,0,0,0,0,1,0,1,1,0,1,1],
[1,1,0,0,0,1,1,1,0,0,1,1,1,0,0,1,1,0,1,1,1,1,1,1,1],
[1,1,0,1,1,1,1,1,0,1,1,1,1,0,1,0,1,1,1,1,1,1,1,1,1],
[1,0,0,1,0,1,1,1,0,0,1,1,1,0,1,1,0,1,1,1,1,1,1,0,0],
[1,0,0,1,1,1,0,1,1,0,0,0,1,1,0,1,1,0,0,0,0,0,0,1,1],
[1,0,0,0,1,1,1,1,1,1,1,1,0,0,0,1,1,1,1,1,1,1,0,0,1],
[1,0,0,1,0,1,1,1,1,1,1,0,1,1,1,1,1,0,0,0,0,1,1,1,1],
[1,1,0,0,1,0,1,0,1,0,0,0,1,1,1,1,1,1,1,0,0,0,0,0,0],
[1,1,0,0,0,0,1,0,0,0,0,1,1,1,1,1,1,1,0,1,1,1,1,0,0],
[0,1,1,1,0,0,0,0,0,1,1,1,1,1,1,0,0,0,1,1,1,1,1,1,1],
[0,0,1,1,1,1,1,1,1,1,1,1,1,0,0,0,0,0,0,0,0,0,1,1,1],
],
"9409":[
[0,0,0,0,0,0,0,0,0,0,0,0,0,1,1,1,1,1,1,1,0,0,0,0,0],
[0,0,0,0,0,0,0,0,0,0,0,1,1,1,0,0,0,0,0,1,1,1,1,0,0],
[0,0,0,0,0,0,0,0,0,0,1,1,0,0,1,1,1,1,1,0,0,0,1,1,0],
[0,0,0,0,0,1,1,1,1,1,1,1,1,1,1,1,1,1,1,1,1,1,0,1,0],
[0,0,1,1,1,1,0,0,0,0,0,1,1,1,1,1,0,0,0,1,1,1,0,1,0],
[0,1,1,0,0,0,1,1,1,1,1,0,0,0,1,1,1,0,1,1,1,0,0,1,0],
[0,1,0,1,1,1,1,1,1,1,1,1,1,1,0,1,1,1,1,0,0,0,1,1,0],
[0,1,0,1,1,1,1,0,0,0,1,1,1,1,0,1,1,0,0,1,1,1,1,0,0],
[0,1,0,1,1,1,0,0,0,0,0,1,1,0,0,1,1,1,1,0,0,0,1,1,0],
[0,1,1,0,0,0,1,1,1,1,1,0,0,0,1,1,0,0,0,0,1,1,0,1,0],
[0,0,1,1,1,1,0,0,0,0,0,1,1,1,1,1,0,0,0,1,0,1,0,1,0],
[0,1,1,0,0,1,1,1,1,1,1,1,1,0,1,1,1,1,1,1,1,1,0,1,1],
[0,1,0,1,0,0,0,0,0,0,1,1,1,0,0,1,1,0,0,1,1,1,1,0,1],
[0,1,0,0,1,1,0,0,0,0,0,1,1,1,0,1,1,1,1,1,0,0,1,0,1],
[1,1,0,0,1,1,1,1,1,1,1,1,0,1,0,1,1,0,1,0,1,1,1,0,1],
[1,0,0,1,0,0,1,1,1,0,1,0,0,1,0,0,1,1,1,1,0,1,1,0,1],
[1,0,0,1,0,0,0,0,1,0,1,1,1,0,1,0,1,1,0,0,1,1,1,0,1],
[1,0,0,1,1,0,0,0,0,1,1,1,0,1,1,0,1,1,1,1,0,1,1,0,1],
[1,0,0,1,1,0,0,0,0,1,1,1,1,1,1,0,1,1,1,1,1,0,0,0,1],
[1,0,0,1,1,1,0,0,1,0,0,0,1,0,1,0,1,1,0,0,0,0,0,1,1],
[1,0,0,1,1,0,1,1,0,1,1,1,0,1,1,0,1,0,0,0,1,1,1,1,1],
[1,0,0,0,0,1,1,1,1,1,1,1,1,0,0,0,1,1,1,1,1,1,1,1,1],
[1,1,0,0,0,0,0,0,0,0,0,0,0,0,0,1,1,1,1,1,1,1,1,0,0],
[1,1,1,1,1,0,0,0,0,0,0,0,1,1,1,1,1,1,0,0,0,0,0,0,0],
[0,0,1,1,1,1,1,1,1,1,1,1,1,1,0,0,0,0,0,0,0,0,0,0,0],
],
"9410":[
[0,0,0,0,0,0,0,0,0,0,0,0,0,0,1,1,0,1,1,1,1,1,1,1,0,0,0,0,0,0],
[0,0,0,0,0,0,0,0,0,0,0,1,1,1,1,0,1,0,0,0,1,0,1,0,1,1,0,0,0,0],
[0,0,0,0,0,0,0,1,1,1,1,1,0,1,0,1,1,0,1,1,0,1,1,1,1,0,1,0,0,0],
[0,0,0,0,0,1,1,1,0,1,1,0,0,1,1,1,1,1,1,1,1,0,1,1,0,0,1,0,0,0],
[0,0,0,0,1,1,1,0,0,1,1,0,1,1,1,1,0,1,0,1,1,1,0,1,1,0,1,0,0,0],
[0,0,0,1,1,0,0,1,1,0,1,1,1,1,0,0,1,0,1,1,0,1,0,0,1,1,0,0,0,0],
[0,0,1,1,1,1,1,1,1,1,0,0,1,1,0,1,1,0,1,0,0,1,1,1,1,1,0,0,0,0],
[0,0,1,0,1,1,0,0,1,1,1,1,0,1,1,1,1,1,1,1,1,1,1,1,0,1,0,0,0,0],
[0,1,1,1,0,1,0,1,1,1,1,1,1,1,1,0,1,0,1,1,1,0,0,1,0,1,0,0,0,0],
[0,1,0,1,1,1,0,1,0,0,1,1,0,1,0,1,1,0,1,1,1,0,0,1,0,1,0,0,0,0],
[1,1,0,1,0,1,1,1,1,1,1,0,0,1,1,0,0,1,1,1,1,0,0,0,0,1,0,0,0,0],
[1,1,1,0,1,0,0,1,1,0,1,1,0,1,0,1,1,1,0,1,1,1,0,0,0,1,1,0,0,0],
[1,0,0,0,1,0,1,1,0,0,1,1,1,0,1,1,1,1,0,0,0,1,1,0,0,1,1,0,0,0],
[1,0,1,1,1,1,1,1,1,1,1,0,1,1,1,1,0,1,1,0,0,0,0,0,0,0,1,0,0,0],
[1,1,1,0,1,1,0,0,1,0,1,0,0,1,1,1,0,0,1,0,0,0,0,0,0,0,1,0,0,0],
[1,0,0,1,1,1,1,1,1,1,1,1,0,1,0,1,1,0,1,0,0,0,0,0,0,0,1,1,0,0],
[1,1,0,1,1,0,1,0,1,0,1,1,1,1,0,0,1,0,0,0,0,0,0,0,0,1,0,1,0,0],
[1,1,1,1,0,1,1,0,1,1,1,0,1,0,0,0,0,0,0,0,1,0,0,0,0,1,0,1,1,0],
[1,0,1,0,0,0,1,1,1,1,1,0,1,1,0,0,0,0,0,0,1,0,0,0,0,1,1,0,1,1],
[1,1,1,1,1,0,1,0,1,0,0,1,1,1,1,0,0,0,0,0,1,0,0,0,0,0,1,1,0,1],
[1,1,1,0,1,1,1,0,1,1,0,1,1,0,1,1,0,0,0,0,0,0,0,1,0,0,1,1,0,1],
[1,0,1,1,0,1,1,1,0,1,1,1,1,0,0,0,0,1,1,0,0,0,0,1,0,1,0,1,0,1],
[1,0,1,1,1,1,1,1,1,0,1,1,0,0,0,0,0,0,1,1,1,1,0,1,0,1,0,1,0,1],
[1,1,0,0,1,1,0,1,0,0,1,1,1,1,1,1,1,1,0,0,1,1,1,0,1,0,1,0,1,1],
[1,1,1,1,0,1,0,0,1,1,1,1,0,0,0,0,0,1,1,1,0,1,1,0,0,1,1,0,1,0],
[1,1,1,1,1,1,1,1,1,1,1,1,1,1,0,0,0,0,0,1,0,0,1,1,1,1,0,0,1,1],
[0,0,1,1,1,1,1,1,1,1,1,1,1,1,1,1,1,1,1,1,1,0,0,1,1,0,0,1,1,1],
[0,0,0,0,0,0,0,0,0,1,1,1,1,1,1,1,1,1,1,1,1,1,0,0,0,1,1,1,1,1],
[0,0,0,0,0,0,0,0,0,0,0,1,1,1,1,1,1,1,1,1,1,1,1,1,1,1,1,1,1,0],
[0,0,0,0,0,0,0,0,0,0,0,0,0,0,0,1,1,1,1,1,1,1,1,1,1,1,0,0,0,0],
],
"9411":[
[0,0,0,0,0,0,0,0,0,0,0,0,0,0,0,0,0,0,0,0,0,0,0,0,1,1,1,1,0,0],
[0,0,0,0,0,0,1,1,1,1,1,1,1,0,0,0,0,0,0,0,0,1,1,1,1,0,0,1,1,0],
[0,0,0,0,1,1,1,0,0,0,0,0,1,1,1,1,0,1,1,1,1,1,0,0,0,1,1,0,1,0],
[0,0,0,1,1,0,0,0,0,0,0,0,0,0,0,1,1,1,0,0,0,0,1,0,1,1,1,0,1,0],
[0,0,1,1,0,1,0,1,0,1,1,1,0,0,0,0,0,1,0,1,1,1,1,1,1,0,0,1,1,0],
[0,1,1,0,0,1,1,0,0,0,0,0,0,1,1,1,0,0,1,1,1,1,0,0,0,1,1,1,0,0],
[0,1,1,0,1,0,1,0,0,1,1,1,1,1,1,1,1,1,1,1,0,0,1,1,1,1,1,0,0,0],
[1,1,0,1,1,1,1,1,1,1,1,1,0,0,0,0,1,1,1,1,1,1,1,1,0,0,0,0,0,0],
[1,1,0,1,1,1,1,1,0,0,0,0,0,0,0,1,0,0,1,0,0,0,1,0,0,0,0,0,0,0],
[1,1,1,1,1,0,0,0,0,1,1,0,0,1,1,1,0,0,1,1,0,0,1,1,0,0,0,0,0,0],
[1,1,1,0,0,0,0,1,1,1,1,0,1,1,0,0,1,0,1,1,0,0,0,1,0,0,0,0,0,0],
[1,1,0,0,0,0,1,1,1,1,0,0,0,0,0,0,1,0,1,1,0,1,0,1,0,0,0,0,0,0],
[1,1,0,1,0,1,1,1,0,0,0,0,0,0,0,1,1,0,1,1,0,1,0,1,1,1,1,1,0,0],
[1,0,0,1,0,1,0,0,0,0,1,0,1,0,1,1,0,1,1,0,1,0,1,1,1,0,0,1,1,0],
[1,0,0,1,1,0,0,0,0,1,0,0,1,1,1,1,1,1,1,1,1,1,1,0,0,0,1,0,1,0],
[1,1,0,1,1,0,1,0,0,1,0,1,1,1,1,1,1,1,1,0,1,1,1,0,1,0,1,0,1,1],
[0,1,0,0,1,1,1,1,1,1,1,1,1,0,0,0,0,1,1,1,1,1,0,1,0,1,0,0,0,1],
[0,1,0,0,1,1,1,1,1,1,1,1,0,0,1,1,0,1,1,1,1,1,0,1,0,1,0,0,0,1],
[0,1,1,0,0,1,1,1,1,1,0,0,1,0,1,1,1,0,1,1,0,1,1,1,1,0,0,1,0,1],
[0,0,1,0,1,1,1,1,1,0,0,1,0,1,0,1,1,0,1,0,1,0,0,1,1,0,1,1,0,1],
[0,0,1,1,1,0,0,0,0,0,0,0,1,0,1,1,0,0,1,0,1,0,1,0,1,1,0,1,0,1],
[0,0,1,1,0,0,0,0,0,0,1,1,1,0,1,1,0,1,1,0,1,1,0,0,1,1,0,1,0,1],
[1,1,1,1,0,0,1,1,1,0,0,0,0,0,1,0,0,1,1,0,1,1,1,0,0,1,1,0,0,1],
[1,1,1,1,1,0,0,0,0,0,0,0,0,1,1,0,0,1,1,0,1,0,1,1,0,1,1,0,0,1],
[1,1,1,1,1,0,0,0,0,1,1,1,1,1,0,0,1,1,1,0,1,0,0,1,0,0,1,1,1,1],
[0,1,1,1,1,1,1,0,0,0,1,1,1,0,0,1,1,1,1,0,1,1,1,1,1,0,1,1,1,1],
[0,0,0,0,1,1,1,1,1,1,0,0,0,0,1,1,0,1,1,1,0,1,1,1,0,0,1,1,1,1],
[0,0,1,1,0,1,0,1,1,1,1,1,1,1,1,1,1,0,0,1,1,0,0,0,0,1,1,1,0,0],
[0,0,0,0,0,0,0,0,1,0,1,1,1,1,1,1,1,1,1,0,0,0,0,1,1,1,1,0,0,0],
[0,0,0,0,0,0,0,0,0,0,0,0,0,0,0,0,0,1,1,1,1,1,1,1,1,0,0,0,0,0],
],
"9412":[
[0,0,0,0,0,0,0,1,1,1,1,1,1,1,0,0,0,0,0,0,0,0,0,0,0,0,0,0,0,0],
[0,0,0,1,1,1,1,1,0,0,0,0,0,1,1,0,0,1,1,1,0,0,0,0,1,1,1,1,1,1],
[0,0,1,1,0,0,0,0,0,1,1,0,1,0,1,0,1,1,0,1,0,1,1,1,1,0,0,0,0,1],
[0,0,1,0,0,0,1,1,1,1,0,1,1,0,1,1,1,0,1,1,1,1,0,0,0,1,0,1,0,1],
[0,1,1,0,1,1,0,0,1,1,1,1,1,1,1,1,0,0,1,1,0,0,0,1,1,1,1,1,0,1],
[0,1,0,1,1,0,1,1,1,1,1,0,0,0,0,0,0,1,1,0,1,1,1,1,1,0,1,1,0,1],
[1,1,0,1,0,0,0,1,1,1,0,0,1,0,1,0,0,1,1,1,0,0,0,1,0,1,0,0,1,1],
[1,0,1,0,0,1,1,1,0,0,0,1,1,1,1,0,1,1,1,1,1,1,1,0,0,0,1,1,1,0],
[1,0,0,1,1,1,1,1,0,0,1,0,1,1,1,0,1,1,0,0,0,1,1,1,1,1,1,1,0,0],
[1,0,0,0,1,1,1,0,0,0,0,1,1,1,0,0,1,1,1,0,0,0,0,0,1,1,1,0,0,0],
[1,1,1,1,1,0,1,0,1,0,1,1,1,1,0,0,1,1,1,1,1,0,0,0,0,0,1,1,0,0],
[0,0,1,1,0,1,1,0,0,1,1,0,1,0,0,0,1,1,1,0,1,1,1,1,0,0,1,1,1,0],
[0,0,1,0,1,1,0,0,1,0,0,1,0,0,0,1,1,1,0,1,0,1,1,1,1,0,1,0,1,0],
[0,1,1,0,1,1,0,0,1,0,0,1,0,0,1,1,0,0,1,0,1,0,1,0,0,0,1,0,1,1],
[1,0,1,0,1,1,0,0,1,0,0,0,0,0,1,1,0,0,0,0,0,0,0,0,0,1,1,0,0,1],
[1,0,1,0,0,1,0,0,0,0,0,0,0,1,1,1,1,1,0,0,0,0,0,1,1,1,0,1,0,1],
[1,0,1,1,0,1,1,0,0,0,1,1,1,1,0,1,1,1,1,1,1,1,1,1,1,1,1,0,0,1],
[1,0,1,1,0,0,1,1,1,1,1,1,1,0,1,0,1,1,1,1,1,1,0,0,1,0,1,1,0,1],
[1,0,1,1,1,0,0,1,1,0,0,1,1,0,0,1,1,0,1,1,1,1,1,0,0,1,1,0,0,1],
[1,0,0,1,1,1,0,0,0,0,1,1,1,0,0,1,0,1,0,1,0,0,1,1,0,0,1,0,0,1],
[1,0,0,0,0,1,1,1,1,1,1,1,1,1,0,0,0,0,0,0,1,1,1,1,0,0,0,0,1,1],
[1,0,0,1,0,0,1,1,0,1,1,1,1,1,1,1,1,1,1,1,0,0,1,1,1,1,1,1,1,1],
[1,0,0,1,1,0,0,0,0,0,0,0,0,0,0,0,0,0,0,0,0,0,0,1,1,1,1,0,0,1],
[0,1,0,1,1,1,1,1,0,0,1,1,1,1,1,0,0,0,1,1,1,1,1,1,1,1,1,0,1,0],
[0,1,0,1,1,0,1,0,1,0,0,0,1,1,0,1,0,1,1,1,1,0,0,1,1,0,1,0,1,0],
[0,1,0,0,1,1,0,1,1,1,0,0,0,0,1,0,1,0,1,0,0,1,1,0,0,1,0,0,1,0],
[1,1,0,0,1,0,1,0,1,1,1,0,1,0,1,1,0,0,0,0,1,0,0,1,0,0,0,0,1,1],
[1,1,1,1,0,0,0,0,0,1,1,1,0,0,1,1,1,0,0,1,0,1,0,0,0,0,1,1,1,1],
[1,1,1,1,1,1,1,0,0,0,0,0,0,0,0,0,0,0,0,0,0,0,0,1,1,1,1,1,1,1],
[0,0,0,0,0,0,0,1,1,1,1,1,1,1,1,1,1,1,1,1,1,1,1,1,1,1,0,0,0,0],
],
}